variant	af_tot	ac_tot	an_tot	hom_tot	hom_xx	hom_xy	quality
22-10510356-T-A	0.166667	2	12	4366	2211	2155	23
22-10511391-T-A	0.166667	2	8	613	295	318	10
22-10511551-A-G	0.166667	2	8	1	0	1	14
22-10511641-A-G	0.25	3	12	1	0	1	14
22-10514784-G-A	0.166667	2	10	0	0	0	11
22-10514994-G-A	0.333333	4	8	906	456	450	17
22-10515170-C-T	0.333333	4	6	66	28	38	12
22-10515354-T-C	0.666667	8	10	15	8	7	27
22-10516227-ATATATATG-A	0.166667	2	10	323	205	118	20
22-10516333-G-T	0.5	6	12	438	242	196	20
22-10516689-C-G	0.166667	2	12	4500	2372	2128	20
22-10516743-T-C	0.166667	2	12	8670	4633	4037	19
22-10522452-C-T	0.166667	2	12	0	0	0	10
22-10522483-C-A	0.166667	2	10	0	0	0	14
22-10522591-C-A	0.333333	4	12	7	3	4	14
22-10522608-C-CAATA	0.083333	1	10	2039	1004	1035	19
22-10522608-CAATA-C	0.083333	1	10	12	7	5	19
22-10522699-G-C	0.166667	2	4	0	0	0	16
22-10522700-G-T	0.166667	2	4	0	0	0	13
22-10522819-C-T	0.5	6	12	3029	1594	1435	29
22-10524197-A-AG	0.166667	2	12	0	0	0	25
22-10525670-C-G	0.166667	2	8	0	0	0	21
22-10525838-C-G	0.333333	4	10	0	0	0	11
22-10525882-G-T	0.166667	2	8	2	0	2	11
22-10526058-G-GGCCGTCGCGTCTTTTTGCCCCCGCCGCCCCGGCTTTTT	0.25	3	8	651	360	291	31
22-10526438-A-G	0.666667	8	12	44597	23095	21502	41
22-10526445-A-G	0.666667	8	12	45405	23548	21857	41
22-10526584-C-A	0.166667	3	6	0	0	0	19
22-10526600-C-A	0.083333	1	8	508	270	238	16
22-10526719-C-CGCCGCCGCGGATTTTT	0.083333	1	12	1	0	1	24
22-10526739-C-T	0.5	6	10	1068	563	505	30
22-10526799-T-C	0.333333	4	12	28	15	13	36
22-10526882-A-G	0.5	6	8	4	2	2	37
22-10527027-TGCCGCCGCGGCTTTTTGCCCCC-T	0.166667	2	8	702	316	386	17
22-10527074-A-G	0.333333	4	12	2550	1379	1171	55
22-10527208-G-C	0.083333	1	12	1	1	0	25
22-10527251-A-T	0.333333	4	12	57	32	25	41
22-10527916-T-G	0.666667	8	12	3	1	2	21
22-10528753-C-CAA	0.166667	2	10	1	0	1	19
22-10528772-T-A	0.166667	2	12	36	15	21	10
22-10528978-A-G	0.166667	2	10	5	3	2	11
22-10530683-A-ATGAAC	0.083333	1	12	440	206	234	22
22-10531300-AATGAAATG-A	0.333333	4	12	2071	1157	914	22
22-10531501-C-A	0.333333	4	6	0	0	0	10
22-10531776-GATGAA-G	0.083333	1	12	59	25	34	14
22-10531789-G-GATGAA	0.083333	1	12	4646	2400	2246	14
22-10531934-A-G	0.166667	2	8	969	479	490	31
22-10532040-T-C	0.166667	1	12	3110	1579	1531	12
22-10534570-G-T	0.25	3	9	0	0	0	10
22-10534781-T-C	0.166667	2	12	711	387	324	18
22-10534788-T-C	0.5	6	12	3038	1691	1347	24
22-10534861-T-G	0.166667	1	12	2404	1245	1159	13
22-10536872-T-C	0.166667	2	10	10	8	2	14
22-10540066-A-T	0.166667	2	8	0	0	0	16
22-10540132-A-T	0.333333	4	8	1119	602	517	21
22-10540140-AC-A	0.333333	4	8	1220	657	563	23
22-10540947-T-C	1	12	12	12	7	5	11
22-10541009-A-G	0.666667	7	12	3	2	1	17
22-10542780-CGTGT-C	0.583333	6	8	0	0	0	13
22-10542780-CGT-C	0.25	2	8	0	0	0	13
22-10543518-C-T	0.166667	2	12	0	0	0	10
22-10543540-GC-G	0.333333	4	12	0	0	0	12
22-10548545-A-T	0.166667	2	12	1065	514	551	18
22-10550719-A-G	0.166667	2	10	0	0	0	12
22-10551859-G-T	0.166667	2	12	311	155	156	13
22-10551892-C-T	0.166667	2	12	214	113	101	10
22-10551895-A-G	0.166667	2	12	178	86	92	11
22-10553453-A-C	0.166667	2	10	0	0	0	15
22-10553503-T-G	0.166667	2	10	506	277	229	10
22-10553536-G-C	0.166667	2	12	668	356	312	14
22-10554689-C-A	0.666667	8	12	37033	19324	17709	25
22-10557811-T-C	0.333333	4	4	1490	775	715	24
22-10560072-C-T	0.166667	2	12	NA	NA	NA	12
22-10560580-A-AC	0.166667	2	12	44	22	22	11
22-10560894-C-T	0.333333	4	6	312	163	149	20
22-10560916-G-A	0.333333	4	6	347	185	162	18
22-10561171-T-G	0.666667	8	10	2574	1412	1162	26
22-10561259-T-G	0.416667	5	8	2	2	0	13
22-10561282-A-G	0.833333	10	10	4567	2502	2065	30
22-10561355-C-G	0.5	5	12	4630	2450	2180	27
22-10561458-A-AGAAT	0.333333	4	12	1115	610	505	22
22-10561588-T-G	0.333333	4	8	5429	2882	2547	25
22-10561791-GA-G	0.416667	5	12	469	247	222	32
22-10561805-AAAAG-A	0.083333	1	10	117	56	61	18
22-10562434-G-A	0.166667	1	12	3	2	1	12
22-10562570-T-C	0.333333	4	10	0	0	0	21
22-10562806-C-T	0.25	3	6	368	194	174	11
22-10563114-T-C	0.5	6	8	25	10	15	17
22-10563688-T-C	0.333333	4	10	17	4	13	18
22-10563709-G-C	0.333333	4	12	0	0	0	16
22-10563896-T-C	0.333333	4	10	426	234	192	16
22-10563919-A-G	0.333333	4	10	379	210	169	19
22-10563931-T-G	0.333333	4	10	315	174	141	22
22-10564092-T-C	0.166667	2	12	0	0	0	10
22-10566807-C-T	0.333333	4	10	1665	884	781	18
22-10567064-T-G	0.333333	4	12	12	7	5	12
22-10567292-G-GA	0.666667	8	8	0	0	0	13
22-10567369-G-GA	0.166667	2	8	8296	4378	3918	11
22-10567370-G-A	0.166667	2	12	2253	1187	1066	31
22-10567370-G-T	0.166667	2	12	24	11	13	31
22-10567701-C-A	0.416667	5	12	6164	3186	2978	20
22-10567859-C-T	0.166667	2	10	3798	1984	1814	16
22-10568003-A-C	0.333333	4	10	681	378	303	13
22-10568032-G-T	0.333333	4	12	444	227	217	18
22-10568797-T-C	0.166667	2	6	29	19	10	11
22-10570184-C-T	0.083333	1	12	282	144	138	11
22-10570288-G-T	0.333333	4	10	3282	1730	1552	18
22-10570455-C-T	0.416667	5	12	6820	3571	3249	31
22-10571613-G-A	0.083333	1	10	576	315	261	29
22-10571710-A-G	0.416667	5	10	99	56	43	34
22-10571755-C-CT	0.25	3	10	99	51	48	17
22-10571772-T-G	0.416667	5	12	290	160	130	27
22-10571787-T-C	0.083333	1	10	21	13	8	18
22-10571800-T-C	0.166667	2	12	0	0	0	12
22-10571867-T-A	0.333333	4	8	2042	1047	995	30
22-10571879-T-C	0.416667	5	12	1483	735	748	29
22-10572033-C-CCCGCCGCGGCTTTTTGCCCTCTG	0.166667	2	10	7469	3986	3483	28
22-10572103-G-A	0.083333	1	12	125	63	62	16
22-10572151-T-C	0.333333	4	8	3537	1829	1708	37
22-10572212-G-C	0.166667	2	10	17	11	6	28
22-10572352-T-C	0.416667	5	10	489	264	225	20
22-10572443-C-G	0.25	3	12	144	73	71	22
22-10572523-C-T	0.333333	4	12	1	1	0	14
22-10572567-C-T	0.333333	4	6	700	378	322	16
22-10572593-C-T	0.333333	4	10	978	551	427	20
22-10572609-GCCGCCGCGGCTTCTTGC-G	0.083333	1	10	576	295	281	37
22-10572683-C-T	0.25	3	12	163	88	75	36
22-10572766-A-T	0.333333	4	8	1	0	1	14
22-10572803-T-C	0.833333	10	12	14752	7831	6921	53
22-10572812-GC-G	0.416667	5	8	1451	830	621	14
22-10572870-G-A	0.333333	4	12	19	9	10	17
22-10572965-A-C	0.166667	2	12	17	7	10	10
22-10573047-A-C	0.166667	2	10	0	0	0	24
22-10573147-G-A	0.333333	4	10	6987	3823	3164	38
22-10577356-C-G	0.333333	4	12	3221	1729	1492	18
22-10579393-C-T	0.333333	4	8	610	320	290	29
22-10580041-G-C	0.333333	4	12	0	0	0	13
22-10583848-C-G	0.333333	4	10	3	1	2	11
22-10586815-T-C	0.25	3	8	4881	2738	2143	31
22-10586832-C-T	0.25	3	8	1910	1123	787	31
22-10586833-A-G	0.25	3	8	5268	2945	2323	30
22-10586857-C-T	0.416667	5	8	2033	1155	878	40
22-10586940-T-C	0.166667	2	4	1711	972	739	20
22-10587286-T-C	0.083333	1	12	23	12	11	22
22-10587558-A-C	0.5	6	12	1452	810	642	17
22-10587764-A-C	0.166667	2	10	1	0	1	13
22-10588010-C-A	0.166667	2	12	12	6	6	22
22-10591086-T-C	0.166667	2	12	0	0	0	10
22-10591189-A-G	0.333333	4	8	1231	617	614	34
22-10591209-G-A	0.166667	2	10	5	4	1	11
22-10591274-A-G	0.333333	4	12	0	0	0	13
22-10591327-T-C	0.333333	4	10	1827	985	842	17
22-10591478-C-G	0.333333	4	12	3019	1615	1404	32
22-10592759-C-T	0.25	3	12	1711	930	781	19
22-10592869-T-C	0.166667	2	8	9	6	3	13
22-10595448-A-AATAT	0.166667	2	10	2408	1326	1082	11
22-10595715-T-G	0.333333	3	12	136	72	64	23
22-10595745-T-A	0.166667	2	12	266	153	113	19
22-10598470-TA-T	0.333333	4	12	5	2	3	12
22-10598651-C-G	0.666667	8	8	19140	10000	9140	23
22-10601392-C-A	0.166667	2	12	79	45	34	14
22-10604106-G-A	0.666667	8	12	4573	2438	2135	27
22-10606281-T-C	0.166667	2	12	53	32	21	10
22-10606330-A-T	0.333333	4	10	2931	1588	1343	35
22-10607802-A-T	0.166667	2	8	0	0	0	26
22-10611320-T-A	0.25	3	12	1315	714	601	33
22-10611694-A-C	0.083333	1	12	4092	2070	2022	10
22-10613339-A-G	0.333333	4	12	1888	1039	849	16
22-10613451-T-C	0.166667	2	10	1199	663	536	19
22-10613512-T-C	0.083333	1	12	1737	912	825	16
22-10613628-CA-C	0.25	2	8	825	438	387	11
22-10615272-G-A	0.166667	2	12	0	0	0	17
22-10615632-G-T	0.333333	4	12	306	169	137	24
22-10615858-C-A	0.166667	2	10	2787	1521	1266	19
22-10617852-G-A	0.166667	2	12	1071	565	506	15
22-10618238-C-G	0.166667	2	10	901	504	397	19
22-10618533-C-T	0.666667	8	12	34345	17844	16501	38
22-10618648-A-C	0.166667	2	12	744	397	347	10
22-10618764-G-A	0.166667	1	12	2172	1113	1059	10
22-10619463-A-T	0.333333	4	12	101	52	49	23
22-10620029-CAGATAGAT-C	0.25	2	12	532	293	239	13
22-10620055-GATA-G	0.166667	2	10	771	411	360	14
22-10625375-A-C	0.666667	8	12	43	22	21	19
22-10626254-A-C	0.333333	4	12	398	230	168	21
22-10629018-G-A	0.083333	1	8	1880	1028	852	14
22-10629050-G-A	0.166667	2	10	6533	3476	3057	17
22-10629344-T-A	0.25	3	12	4404	2344	2060	14
22-10629412-C-T	0.083333	1	12	269	123	146	10
22-10629532-C-T	0.25	3	12	6436	3451	2985	29
22-10631508-T-G	0.666667	8	12	24474	12968	11506	43
22-10632224-A-G	0.333333	4	12	4043	2218	1825	29
22-10633088-A-G	0.333333	4	12	4799	2565	2234	16
22-10633365-G-T	0.083333	1	12	3313	1702	1611	16
22-10633642-G-A	0.25	3	12	6364	3378	2986	14
22-10633650-C-A	0.25	3	12	6235	3299	2936	14
22-10634203-G-A	0.416667	5	12	1469	819	650	16
22-10634226-C-A	0.416667	5	12	1329	729	600	20
22-10634609-C-T	0.083333	1	12	5034	2527	2507	15
22-10635573-C-T	0.333333	4	12	7469	4039	3430	28
22-10635889-A-G	0.666667	8	12	41299	21714	19585	36
22-10639080-AG-A	0.25	2	12	11329	5971	5358	15
22-10640044-T-C	0.166667	2	8	0	0	0	11
22-10640263-TGATGA-T	0.25	3	12	962	558	404	12
22-10640283-AAAT-A	0.083333	1	12	996	480	516	11
22-10640689-G-A	0.166667	2	12	39	23	16	10
22-10641244-AATG-A	0.166667	2	12	116	61	55	14
22-10641360-G-A	0.666667	8	12	37629	19690	17939	38
22-10641443-GATGAA-G	0.083333	1	8	2134	1137	997	27
22-10641522-G-A	0.083333	1	12	3946	2065	1881	13
22-10641596-TGA-T	0.166667	2	12	690	380	310	18
22-10641796-T-C	0.166667	2	10	2310	1276	1034	18
22-10642272-G-C	0.25	3	12	9581	5115	4466	15
22-10649011-A-G	0.083333	1	12	645	313	332	21
22-10649819-A-G	0.166667	2	6	0	0	0	10
22-10650244-G-T	0.166667	2	6	12	5	7	17
22-10650287-C-A	0.166667	2	10	1871	966	905	13
22-10650979-G-T	0.083333	1	12	0	0	0	11
22-10651261-G-GT	0.333333	4	10	7920	4332	3588	31
22-10652872-G-GT	0.333333	4	4	4577	2496	2081	15
22-10652909-G-A	0.333333	4	4	7862	4262	3600	18
22-10653047-C-G	0.333333	4	4	14872	7796	7076	21
22-10653105-A-G	0.333333	4	4	13608	7155	6453	18
22-10653187-T-C	0.333333	4	4	6491	3343	3148	12
22-10653204-G-T	0.5	6	6	6105	3147	2958	19
22-10653286-A-G	0.166667	2	6	719	378	341	15
22-10653288-A-C	0.166667	2	4	660	348	312	12
22-10653363-G-A	0.333333	4	8	103	53	50	11
22-10653810-C-T	0.333333	4	6	18	8	10	15
22-10653827-T-C	0.333333	4	12	377	211	166	22
22-10654781-A-T	0.166667	2	10	168	80	88	10
22-10655100-T-A	0.166667	2	12	372	177	195	11
22-10657334-TA-T	0.416667	5	12	8033	4479	3554	26
22-10657567-C-G	0.333333	4	6	613	337	276	16
22-10657701-T-C	0.333333	4	4	2679	1446	1233	16
22-10657723-G-C	0.166667	2	6	1717	920	797	13
22-10657925-G-T	0.333333	4	6	1329	734	595	11
22-10657940-A-C	0.333333	4	6	773	421	352	18
22-10657950-T-G	0.333333	4	6	441	232	209	19
22-10657984-G-A	0.333333	4	10	28	15	13	19
22-10658314-G-A	0.166667	2	4	26	13	13	21
22-10658335-C-A	0.166667	1	12	26	11	15	21
22-10658338-T-G	0.166667	2	2	48	27	21	28
22-10658360-A-G	0.333333	4	4	57	34	23	29
22-10658424-T-C	0.333333	4	6	13	8	5	12
22-10658440-G-C	0.333333	4	6	5	3	2	16
22-10658611-A-G	0.416667	5	6	1041	567	474	16
22-10658654-G-GAGGA	0.333333	4	12	277	144	133	19
22-10658654-GAGGAAGGAAGGA-G	0.25	3	12	1466	756	710	19
22-10658654-GAGGA-G	0.083333	1	12	366	192	174	19
22-10658879-T-C	0.833333	10	10	182	96	86	19
22-10658892-A-T	0.5	6	6	195	104	91	10
22-10658950-C-T	0.333333	4	6	49	20	29	12
22-10659173-C-G	0.166667	2	8	0	0	0	12
22-10659236-A-T	0.333333	4	12	109	60	49	26
22-10659272-G-A	0.333333	4	12	162	91	71	33
22-10659464-A-G	0.416667	5	8	1849	924	925	29
22-10659573-T-C	0.333333	4	6	1	0	1	13
22-10659614-A-G	0.083333	1	10	0	0	0	13
22-10659628-C-T	0.333333	4	6	182	97	85	24
22-10659746-A-C	0.5	6	12	344	187	157	16
22-10660248-C-T	0.083333	1	12	21	9	12	23
22-10660266-C-T	0.333333	4	10	3268	1743	1525	15
22-10660324-T-A	0.333333	4	12	7095	3737	3358	13
22-10660409-A-G	0.333333	4	10	7129	3779	3350	12
22-10660443-T-A	0.333333	4	10	6951	3661	3290	14
22-10660580-G-C	0.333333	4	8	1950	1059	891	20
22-10661034-C-A	0.333333	4	12	2	2	0	17
22-10661179-G-C	0.25	3	12	6155	3187	2968	15
22-10661232-C-T	0.333333	4	12	1366	735	631	63
22-10661302-A-G	0.333333	4	12	1	0	1	16
22-10661416-C-T	0.083333	1	12	15102	7870	7232	19
22-10661494-G-A	0.416667	5	12	8006	4214	3792	50
22-10661519-G-A	0.083333	1	12	6284	3241	3043	37
22-10661629-C-G	0.083333	1	12	6133	3100	3033	38
22-10661684-AT-A	0.083333	1	12	6870	3511	3359	38
22-10661708-T-C	0.083333	1	12	7015	3561	3454	28
22-10661842-A-G	0.333333	4	12	0	0	0	11
22-10661864-TAAAAAATAAA-T	0.166667	2	10	5	3	2	14
22-10661895-T-C	0.333333	4	12	42	28	14	14
22-10661957-T-A	0.083333	1	12	1793	846	947	20
22-10661999-C-T	0.333333	4	10	74	45	29	24
22-10662027-C-G	0.333333	4	8	30	19	11	26
22-10662053-T-C	0.333333	4	12	5	3	2	14
22-10662065-T-C	0.166667	2	10	3	1	2	15
22-10662090-T-A	0.333333	4	12	38	19	19	23
22-10662092-TC-T	0.333333	4	10	50	26	24	25
22-10662132-C-T	0.333333	4	8	1958	1056	902	33
22-10662215-C-T	0.333333	4	8	2508	1389	1119	30
22-10662266-C-CA	0.166667	2	12	0	0	0	14
22-10662280-A-G	0.333333	4	8	1052	541	511	26
22-10662353-T-C	0.333333	4	12	9430	4990	4440	19
22-10662385-C-T	0.166667	2	10	7766	4115	3651	11
22-10662400-G-T	0.166667	2	10	9347	4941	4406	11
22-10662433-C-T	0.166667	2	10	8214	4369	3845	12
22-10662553-C-T	0.333333	4	10	1	1	0	27
22-10662618-G-A	0.333333	4	12	401	203	198	28
22-10662631-C-T	0.083333	1	8	8	5	3	22
22-10662679-C-T	0.333333	4	10	67	35	32	14
22-10662691-T-A	0.416667	5	10	7603	3847	3756	33
22-10662857-T-A	0.333333	4	6	1	0	1	23
22-10662913-C-T	0.583333	7	10	14717	7579	7138	33
22-10662933-A-C	0.333333	4	6	22	9	13	28
22-10662958-T-C	0.333333	4	6	5	2	3	21
22-10662961-T-G	0.333333	4	10	0	0	0	25
22-10662970-A-G	0.166667	2	12	0	0	0	17
22-10662973-A-G	0.083333	1	10	17252	8944	8308	24
22-10662991-C-T	0.083333	1	12	6197	3300	2897	38
22-10663043-A-G	0.166667	2	12	0	0	0	13
22-10663052-T-C	0.083333	1	12	6466	3316	3150	42
22-10663092-G-A	0.166667	2	12	7812	3922	3890	48
22-10663100-A-G	0.083333	1	12	15236	7981	7255	41
22-10663137-T-C	0.416667	5	6	17	5	12	29
22-10663172-CAAAA-C	0.416667	5	8	47	14	33	32
22-10663172-C-CA	0.166667	2	8	2182	1242	940	32
22-10663366-A-C	0.166667	2	12	4	4	0	10
22-10663380-T-C	0.166667	2	10	1	1	0	12
22-10663408-A-G	0.833333	10	12	60134	30872	29262	56
22-10663618-T-C	0.333333	4	8	269	152	117	17
22-10663651-C-T	0.333333	4	10	118	71	47	14
22-10663655-T-C	0.333333	4	8	133	81	52	15
22-10663736-C-A	0.166667	2	12	192	95	97	13
22-10663748-T-C	0.166667	2	10	201	102	99	20
22-10663755-C-T	0.083333	1	10	9	4	5	13
22-10663773-G-T	0.333333	4	8	318	168	150	25
22-10663785-G-C	0.416667	5	12	302	162	140	29
22-10663794-A-G	0.416667	5	12	1022	547	475	29
22-10663841-T-C	0.416667	5	6	157	80	77	35
22-10663844-A-C	0.416667	5	6	131	64	67	31
22-10663866-A-G	0.416667	5	8	764	424	340	27
22-10663870-C-T	0.416667	5	6	40	21	19	27
22-10663878-C-CA	0.333333	4	8	7105	3713	3392	41
22-10663878-C-CAA	0.083333	1	8	484	259	225	41
22-10663905-A-T	0.083333	1	12	4493	2303	2190	50
22-10663973-G-A	0.333333	4	12	729	388	341	54
22-10664006-T-C	0.333333	4	12	969	514	455	22
22-10664044-G-T	0.083333	1	12	598	304	294	11
22-10664114-CA-C	0.5	6	8	2123	1161	962	30
22-10664367-A-T	0.666667	8	12	60640	31125	29515	62
22-10664499-G-A	0.083333	1	12	6184	3100	3084	34
22-10664632-A-C	0.666667	8	12	56643	29130	27513	61
22-10664938-G-T	0.083333	1	12	15016	7761	7255	31
22-10665303-G-A	0.666667	8	12	54370	28103	26267	58
22-10665753-C-T	0.5	6	8	1896	1108	788	31
22-10665839-C-A	0.166667	2	8	77	42	35	28
22-10665932-C-G	0.083333	1	12	0	0	0	31
22-10665936-T-C	0.166667	2	10	0	0	0	10
22-10665938-C-T	0.166667	2	10	0	0	0	10
22-10666086-A-T	0.25	3	10	1787	1034	753	10
22-10666125-T-A	0.166667	2	10	270	149	121	18
22-10666440-G-A	0.083333	1	12	7199	3594	3605	45
22-10666484-T-G	0.083333	1	12	17060	8778	8282	29
22-10666926-A-G	0.083333	1	12	6765	3394	3371	49
22-10667131-C-A	0.666667	8	12	58928	30270	28658	61
22-10667338-C-CA	0.333333	4	10	2476	1380	1096	29
22-10667343-A-AG	0.083333	1	12	2823	1335	1488	40
22-10667565-T-C	0.166667	2	10	1	1	0	10
22-10667575-A-T	0.166667	2	10	1	1	0	12
22-10667674-CTCT-C	0.166667	2	10	1	0	1	34
22-10667676-C-CT	0.166667	2	10	1413	773	640	34
22-10667686-T-G	0.166667	2	10	1	1	0	18
22-10667701-T-C	0.166667	2	6	59	43	16	21
22-10667726-G-A	0.25	3	8	136	84	52	23
22-10667732-C-A	0.333333	4	8	142	91	51	19
22-10667798-C-A	0.333333	4	10	1210	701	509	23
22-10667825-C-G	0.333333	4	10	1048	593	455	22
22-10667841-C-G	0.333333	4	10	603	349	254	23
22-10667844-G-A	0.333333	4	10	523	304	219	13
22-10667882-C-A	0.333333	4	10	210	129	81	21
22-10667887-G-A	0.333333	4	6	176	113	63	21
22-10667888-C-T	0.333333	4	8	171	109	62	18
22-10667906-CTT-C	0.25	3	6	961	522	439	35
22-10667947-A-C	0.416667	5	8	15	10	5	36
22-10668026-C-A	0.5	6	8	3213	1773	1440	59
22-10668197-C-T	0.333333	4	10	253	150	103	26
22-10668212-G-A	0.333333	4	10	425	257	168	29
22-10668320-C-T	0.166667	2	10	25	12	13	20
22-10668321-A-G	0.166667	2	10	21	10	11	22
22-10668402-A-C	0.333333	4	12	3	1	2	11
22-10668440-C-G	0.333333	4	12	0	0	0	11
22-10668523-C-A	0.416667	5	12	14912	7727	7185	16
22-10668554-T-C	0.333333	4	12	1	0	1	18
22-10668592-T-A	0.333333	4	12	887	489	398	19
22-10668600-C-G	0.333333	4	12	1415	792	623	37
22-10668612-A-ATT	0.25	4	10	1972	1121	851	30
22-10668867-CTATA-C	0.25	3	8	1172	582	590	24
22-10668900-T-G	0.333333	4	6	3209	1700	1509	24
22-10668968-G-A	0.333333	4	8	336	180	156	19
22-10668998-A-G	0.416667	5	10	87	46	41	21
22-10669026-T-G	0.333333	4	8	21	9	12	16
22-10669052-C-A	0.25	3	10	1	0	1	21
22-10669089-C-A	0.333333	4	8	17	8	9	13
22-10669111-A-C	0.333333	4	8	30	12	18	14
22-10669175-G-A	0.25	3	12	14475	7460	7015	29
22-10669452-C-T	0.416667	5	12	18506	9664	8842	66
22-10669508-G-A	0.083333	1	12	6561	3261	3300	24
22-10669774-C-G	0.083333	1	12	0	0	0	28
22-10669867-G-A	0.083333	1	12	6662	3309	3353	20
22-10670004-G-T	0.166667	2	12	7	6	1	10
22-10670217-G-T	0.166667	2	10	0	0	0	23
22-10670331-A-G	0.166667	2	10	4	2	2	12
22-10670408-A-G	0.166667	2	4	1	0	1	21
22-10670466-T-C	0.333333	4	6	45	24	21	14
22-10670513-G-C	0.333333	4	6	95	52	43	12
22-10670633-T-A	0.333333	4	8	210	112	98	12
22-10670656-A-G	0.333333	4	10	133	69	64	16
22-10670695-A-G	0.166667	2	8	0	0	0	16
22-10670699-T-A	0.083333	1	12	5646	2809	2837	13
22-10670848-C-T	0.083333	1	12	6411	3206	3205	25
22-10670878-G-A	0.333333	4	12	0	0	0	10
22-10670888-C-T	0.333333	4	12	0	0	0	10
22-10671282-G-T	0.083333	1	12	3745	1894	1851	16
22-10671303-G-A	0.333333	4	12	911	497	414	54
22-10671345-C-T	0.166667	2	10	0	0	0	11
22-10671380-T-C	0.083333	1	12	15499	8026	7473	22
22-10671532-CA-C	0.333333	4	8	5	4	1	21
22-10671537-A-T	0.333333	4	6	1	1	0	16
22-10671573-C-T	0.083333	1	8	6607	3382	3225	10
22-10671695-G-T	0.166667	2	12	2	2	0	30
22-10671735-A-T	0.166667	2	8	0	0	0	25
22-10671789-G-T	0.166667	1	10	0	0	0	11
22-10671800-G-A	0.083333	1	12	6606	3306	3300	30
22-10671851-A-G	0.083333	1	12	5909	2987	2922	12
22-10671935-A-T	0.416667	5	8	15482	8215	7267	53
22-10671954-C-T	0.416667	5	12	15673	8269	7404	44
22-10672021-TA-T	0.416667	4	8	12161	6344	5817	21
22-10672072-C-T	0.083333	1	12	2587	1297	1290	20
22-10672093-T-A	0.333333	4	10	50	27	23	15
22-10672104-C-T	0.333333	4	8	52	28	24	22
22-10672108-G-A	0.333333	4	8	55	30	25	22
22-10672124-T-C	0.333333	4	12	74	44	30	19
22-10672215-T-TAA	0.333333	4	10	16	10	6	17
22-10672316-C-A	0.333333	4	12	1060	566	494	15
22-10672382-C-T	0.333333	4	4	553	309	244	26
22-10672397-TAAAAAAAAAAAAAAAA-T	0.333333	4	6	300	170	130	30
22-10672490-A-T	0.333333	4	12	0	0	0	15
22-10672495-C-T	0.333333	4	10	0	0	0	15
22-10672512-A-C	0.333333	4	8	17296	9116	8180	49
22-10672604-G-A	0.166667	2	10	2	1	1	10
22-10672642-G-T	0.083333	1	12	2763	1293	1470	19
22-10672905-TA-T	0.416667	5	12	2394	1385	1009	49
22-10673015-T-C	0.416667	5	6	7	4	3	32
22-10673144-A-G	0.333333	4	8	1	1	0	21
22-10673307-A-T	0.333333	4	12	231	129	102	28
22-10673539-A-G	0.083333	1	12	6291	3267	3024	32
22-10673626-T-C	0.083333	1	12	3427	1873	1554	21
22-10673696-A-G	0.083333	1	12	3687	1914	1773	25
22-10673714-T-C	0.083333	1	12	10894	5748	5146	25
22-10673731-G-A	0.083333	1	12	11574	6083	5491	24
22-10673872-C-T	0.083333	1	12	2812	1355	1457	34
22-10674143-C-CT	0.083333	1	12	5019	2589	2430	25
22-10675272-T-C	0.083333	1	12	6363	3202	3161	18
22-10675297-T-G	0.083333	1	12	6968	3533	3435	11
22-10675348-A-G	0.083333	1	12	6584	3307	3277	16
22-10675389-C-T	0.083333	1	12	3134	1466	1668	25
22-10675426-G-T	0.083333	1	12	5402	2820	2582	31
22-10675884-CA-C	0.25	3	10	7992	4228	3764	35
22-10675885-A-C	0.333333	4	10	4130	2238	1892	35
22-10675915-C-A	0.333333	4	12	499	270	229	46
22-10676160-T-C	0.166667	2	10	0	0	0	11
22-10676173-C-T	0.166667	2	12	0	0	0	10
22-10676621-CA-C	0.333333	4	12	1434	782	652	55
22-10676744-T-TA	0.333333	4	12	1625	896	729	55
22-10676853-C-T	0.333333	4	12	6820	3689	3131	30
22-10677155-CAAA-C	0.166667	2	8	873	502	371	15
22-10677275-T-C	0.333333	4	12	6277	3427	2850	44
22-10677490-T-G	0.166667	2	8	8	3	5	23
22-10677537-T-A	0.166667	2	10	7	3	4	14
22-10677603-G-A	0.333333	4	12	6392	3479	2913	47
22-10677820-G-C	0.166667	2	12	0	0	0	11
22-10678093-C-T	0.333333	3	12	242	124	118	19
22-10678335-A-G	0.333333	4	4	41	18	23	15
22-10678663-T-C	0.333333	4	12	5609	3028	2581	39
22-10678779-T-C	0.333333	4	12	7236	3954	3282	45
22-10678826-G-A	0.333333	4	12	7626	4168	3458	55
22-10678964-A-G	0.166667	2	6	3452	1900	1552	22
22-10678984-G-T	0.166667	2	2	4714	2602	2112	16
22-10679104-A-G	0.416667	5	6	4198	2324	1874	20
22-10679124-T-G	0.333333	4	10	2884	1618	1266	22
22-10679136-G-T	0.333333	4	10	2581	1453	1128	21
22-10679182-TAGAAA-T	0.333333	4	12	1088	593	495	16
22-10679240-C-T	0.333333	4	10	2910	1546	1364	15
22-10679289-C-T	0.333333	4	10	7814	4164	3650	25
22-10679333-T-C	0.333333	4	10	8759	4662	4097	27
22-10679360-C-T	0.416667	5	12	8072	4296	3776	26
22-10679473-G-A	0.333333	4	12	1066	595	471	32
22-10679684-T-A	0.333333	4	12	1270	698	572	40
22-10679741-G-A	0.333333	4	12	6329	3446	2883	45
22-10679779-G-C	0.333333	4	12	7023	3822	3201	54
22-10680441-C-T	0.333333	4	12	1038	558	480	32
22-10680638-G-A	0.333333	4	8	4231	2323	1908	40
22-10680940-T-C	0.416667	5	12	12217	6324	5893	59
22-10681089-C-T	0.333333	4	12	1507	820	687	37
22-10681505-G-T	0.333333	4	12	1510	815	695	36
22-10681527-C-T	0.333333	4	12	7466	4039	3427	41
22-10681978-T-A	0.333333	4	12	5062	2768	2294	46
22-10682031-A-G	0.666667	8	12	33289	16995	16294	44
22-10682032-A-C	0.666667	8	12	33288	16997	16291	45
22-10682069-A-G	0.333333	4	10	6980	3768	3212	38
22-10682146-A-G	0.333333	4	12	6694	3663	3031	51
22-10682483-G-A	0.333333	4	12	6687	3636	3051	46
22-10682995-T-C	0.333333	4	6	0	0	0	13
22-10683046-C-T	0.333333	4	12	1210	643	567	17
22-10683203-C-A	0.333333	4	8	2873	1580	1293	32
22-10683391-G-C	0.166667	2	12	1	1	0	34
22-10683407-C-G	0.416667	5	10	16279	8496	7783	51
22-10683796-A-G	0.416667	5	12	0	0	0	15
22-10683995-T-C	0.333333	4	4	906	508	398	26
22-10684417-C-T	0.083333	1	8	315	176	139	13
22-10684424-A-C	0.666667	8	8	19831	10506	9325	43
22-10684460-G-A	0.666667	8	10	2353	1284	1069	30
22-10684555-T-G	0.666667	8	10	13846	7257	6589	42
22-10684685-T-G	0.166667	2	4	1	0	1	12
22-10684828-A-C	0.333333	4	10	2245	1221	1024	23
22-10684861-C-T	0.333333	4	10	13	10	3	22
22-10684948-T-A	0.25	3	8	196	106	90	12
22-10684982-C-A	0.666667	8	10	11446	6178	5268	50
22-10685015-G-A	0.333333	4	8	3956	2190	1766	33
22-10685077-G-A	0.333333	4	10	10393	5530	4863	31
22-10685175-C-T	0.333333	4	8	1582	875	707	33
22-10685223-T-C	0.416667	5	6	8261	4520	3741	25
22-10685347-C-G	0.333333	4	8	8055	4349	3706	33
22-10685358-G-T	0.333333	4	10	7863	4236	3627	27
22-10685425-A-T	0.75	9	10	26384	13776	12608	42
22-10685457-A-C	0.416667	5	8	8485	4501	3984	32
22-10685477-T-C	0.083333	1	10	5	3	2	17
22-10685500-G-A	0.333333	4	6	8895	4658	4237	31
22-10685603-T-G	0.166667	2	6	440	234	206	10
22-10685693-A-G	0.333333	4	8	11870	6212	5658	31
22-10685824-A-T	0.333333	4	4	7180	3824	3356	40
22-10685838-G-A	0.333333	4	4	7037	3757	3280	39
22-10686082-TATA-T	0.083333	1	12	356	140	216	10
22-10686136-G-A	0.5	6	10	3788	2246	1542	19
22-10686149-G-A	0.25	3	12	620	301	319	25
22-10686152-T-C	0.416667	5	8	2964	1740	1224	15
22-10686170-T-C	0.083333	1	12	456	183	273	26
22-10686186-C-T	0.333333	4	6	797	442	355	15
22-10686291-A-G	0.333333	4	8	353	188	165	21
22-10686686-C-A	0.333333	4	8	8609	4572	4037	15
22-10686903-C-T	0.25	3	12	487	241	246	21
22-10686933-C-T	0.25	3	8	1594	935	659	10
22-10686984-A-T	0.666667	8	10	15145	8456	6689	46
22-10687187-A-G	0.333333	4	4	12070	6300	5770	27
22-10687227-A-G	0.333333	4	6	914	501	413	24
22-10687635-G-A	0.666667	8	8	15721	8033	7688	39
22-10687852-A-G	0.333333	4	4	4393	2207	2186	40
22-10688075-C-T	0.75	9	10	32811	17052	15759	37
22-10688731-T-C	0.333333	3	8	882	459	423	22
22-10689004-T-A	0.5	6	10	428	230	198	28
22-10689073-C-T	0.416667	5	12	12325	6413	5912	45
22-10689118-T-C	0.333333	4	6	1330	627	703	19
22-10689360-G-A	0.166667	2	10	4	1	3	22
22-10689363-C-T	0.083333	1	12	29	6	23	31
22-10689378-C-T	0.666667	8	8	9108	4986	4122	46
22-10689550-G-A	0.333333	4	12	18	13	5	17
22-10689572-A-C	0.25	3	8	106	58	48	21
22-10690273-G-A	0.666667	8	10	3130	1668	1462	26
22-10690592-T-G	0.083333	1	10	6936	3541	3395	18
22-10690907-A-G	0.083333	1	12	6951	3507	3444	48
22-10691029-T-G	0.083333	1	12	3483	1679	1804	31
22-10691072-T-C	0.5	6	10	1	0	1	15
22-10691124-T-A	0.5	6	12	0	0	0	13
22-10691176-T-A	0.083333	1	12	6650	3401	3249	51
22-10691210-T-C	0.083333	1	12	6820	3465	3355	41
22-10691230-C-A	0.083333	1	10	15169	7888	7281	35
22-10691350-C-G	0.416667	5	10	0	0	0	15
22-10691381-A-G	0.166667	2	8	0	0	0	12
22-10691699-G-GA	0.083333	1	12	16784	8742	8042	42
22-10691842-C-G	0.166667	2	12	2	1	1	61
22-10691979-A-G	0.083333	1	12	3713	1795	1918	56
22-10692140-G-A	0.083333	1	12	6902	3513	3389	43
22-10692231-G-C	0.083333	1	12	7042	3580	3462	60
22-10692402-A-C	0.083333	1	12	7087	3596	3491	25
22-10692561-C-G	0.083333	1	12	5709	2951	2758	12
22-10692632-T-TACA	0.083333	1	8	5456	2814	2642	23
22-10693256-A-T	0.083333	1	12	6394	3301	3093	30
22-10693277-A-G	0.083333	1	12	16391	8576	7815	24
22-10693429-T-C	0.083333	1	12	6619	3379	3240	24
22-10693435-C-T	0.083333	1	12	6621	3380	3241	20
22-10693591-C-G	0.083333	1	12	6871	3477	3394	25
22-10693689-A-G	0.083333	1	12	6909	3499	3410	41
22-10693697-A-G	0.083333	1	12	6893	3492	3401	45
22-10693923-C-CT	0.333333	4	8	21727	11205	10522	43
22-10694015-C-T	0.083333	1	10	3291	1592	1699	21
22-10694016-G-T	0.666667	8	12	0	0	0	24
22-10694333-C-A	0.5	6	8	1367	708	659	11
22-10694464-G-A	0.666667	8	10	10664	5688	4976	29
22-10694475-G-A	0.666667	8	12	6246	3336	2910	28
22-10694694-G-T	0.5	6	10	11	5	6	15
22-10694791-A-T	0.166667	2	10	16	9	7	13
22-10694835-A-G	0.166667	2	12	0	0	0	30
22-10695041-C-T	0.666667	8	10	8068	4091	3977	18
22-10695084-A-C	0.083333	1	12	1588	837	751	17
22-10695182-A-T	0.333333	4	8	141	79	62	13
22-10695322-A-T	0.083333	1	12	5648	2906	2742	29
22-10695357-G-C	0.083333	1	12	5928	3061	2867	24
22-10695458-T-A	0.666667	8	10	299	183	116	20
22-10695571-G-A	0.166667	2	10	314	165	149	12
22-10695603-T-A	0.5	6	8	51214	26397	24817	55
22-10695759-A-G	0.75	9	10	11148	5950	5198	35
22-10695790-C-G	0.416667	5	10	3	0	3	18
22-10695935-G-A	0.166667	2	8	0	0	0	11
22-10695951-G-GA	0.333333	4	8	0	0	0	19
22-10696030-AGTTGAAG-A	0.5	6	9	204	104	100	18
22-10696039-G-C	0.5	6	8	210	108	102	14
22-10696041-TATCTTG-T	0.5	6	8	206	108	98	17
22-10696064-C-T	0.666667	8	10	188	105	83	26
22-10696126-G-A	0.083333	1	12	2275	1108	1167	10
22-10696434-T-C	0.666667	8	12	12469	6496	5973	12
22-10696530-A-C	0.75	9	12	28318	14706	13612	19
22-10696703-C-A	0.5	6	10	0	0	0	16
22-10696705-T-G	0.5	6	12	0	0	0	14
22-10696710-A-G	0.166667	2	10	0	0	0	17
22-10696838-A-C	0.333333	4	10	0	0	0	11
22-10696907-C-T	0.083333	1	12	6945	3512	3433	14
22-10696919-A-G	0.083333	1	12	6972	3525	3447	23
22-10697039-C-T	0.333333	4	8	2	2	0	14
22-10697047-G-C	0.333333	4	8	0	0	0	11
22-10697170-C-T	0.083333	1	12	14770	7693	7077	12
22-10697366-A-G	0.5	6	8	0	0	0	20
22-10697406-C-T	0.083333	1	12	5218	2654	2564	12
22-10697626-A-G	0.166667	2	12	0	0	0	10
22-10697672-G-A	0.083333	1	12	248	129	119	17
22-10697906-C-T	0.333333	4	12	6	1	5	17
22-10697976-A-G	0.5	6	8	15531	8063	7468	14
22-10697994-G-T	0.666667	8	10	0	0	0	13
22-10698301-CTT-C	0.5	5	10	11690	6249	5441	12
22-10698323-C-G	0.166667	2	6	11015	5885	5130	14
22-10698329-A-G	0.166667	2	8	730	406	324	12
22-10698332-C-G	0.666667	8	10	27877	14546	13331	32
22-10698374-G-C	0.666667	8	12	10437	5647	4790	31
22-10698409-T-C	0.583333	7	10	10532	5634	4898	30
22-10698427-G-C	0.666667	8	10	10579	5673	4906	39
22-10698516-AT-A	0.75	9	12	5263	2867	2396	32
22-10698538-C-CT	0.666667	8	10	2122	1163	959	31
22-10698545-T-C	0.666667	8	12	1320	724	596	27
22-10698566-A-G	0.083333	1	12	1666	819	847	39
22-10698578-T-C	0.666667	8	12	82	36	46	28
22-10698620-T-C	0.666667	8	12	1	1	0	23
22-10698674-T-C	0.666667	8	10	2824	1537	1287	28
22-10698681-A-G	0.166667	2	10	13	7	6	16
22-10699174-A-C	0.083333	1	12	6576	3335	3241	40
22-10699181-T-C	0.333333	4	12	54995	28177	26818	67
22-10699222-C-A	0.083333	1	12	5295	2686	2609	24
22-10699288-G-C	0.166667	2	10	0	0	0	10
22-10699300-CCCCCGCCGCCGGGGCTTTTTGCT-C	0.083333	1	8	3581	1853	1728	28
22-10699366-A-C	0.083333	1	10	3081	1614	1467	17
22-10699465-T-C	0.666667	8	12	8313	4373	3940	30
22-10699511-T-G	0.166667	2	6	1438	798	640	40
22-10699513-C-G	0.166667	2	8	47	18	29	40
22-10699517-G-A	0.166667	2	8	40	15	25	30
22-10699520-G-A	0.166667	2	8	44	17	27	27
22-10699523-G-C	0.166667	2	8	38	15	23	32
22-10699525-G-A	0.166667	2	10	29	10	19	30
22-10699537-A-C	0.166667	2	10	18	8	10	29
22-10699550-G-C	0.166667	2	12	9	3	6	20
22-10699616-A-C	0.166667	2	10	0	0	0	11
22-10699669-CTTTTTGCCCCCGCGGCT-C	0.333333	4	4	30658	16165	14493	27
22-10699741-A-T	0.166667	2	4	0	0	0	13
22-10699768-GC-G	0.333333	4	8	1	0	1	16
22-10699793-C-A	0.25	3	8	0	0	0	18
22-10699799-C-T	0.25	3	8	0	0	0	16
22-10699801-C-A	0.25	3	6	0	0	0	15
22-10699811-T-TCCCACC	0.25	3	8	NA	NA	NA	14
22-10699813-C-CG	0.333333	4	9	0	0	0	14
22-10699827-C-A	0.25	3	10	0	0	0	20
22-10699941-C-T	0.333333	4	6	328	184	144	13
22-10699942-G-A	0.083333	1	12	1383	749	634	36
22-10699965-C-T	0.416667	5	8	6353	3215	3138	25
22-10699970-G-A	0.333333	4	8	27	16	11	31
22-10700041-C-T	0.666667	8	12	12469	6646	5823	41
22-10700081-G-A	0.416667	4	8	3	2	1	10
22-10700382-C-CA	0.666667	8	8	12566	6692	5874	37
22-10700547-A-T	0.666667	8	8	14462	7531	6931	20
22-10700709-A-ACAT	0.666667	8	12	2	0	2	25
22-10700725-A-T	0.666667	8	10	3	1	2	16
22-10700742-T-TAAC	0.666667	8	12	1	0	1	33
22-10700756-T-C	0.5	6	10	0	0	0	18
22-10700863-T-C	0.083333	1	12	1218	558	660	12
22-10700893-A-T	0.333333	4	8	273	134	139	21
22-10701405-C-T	0.5	6	8	1297	735	562	20
22-10701611-C-A	0.666667	8	12	0	0	0	18
22-10701629-A-G	0.083333	1	12	2835	1374	1461	27
22-10701756-ATTTGGGATCAAATAC-A	0.666667	8	10	2149	1172	977	16
22-10701805-C-CCTCTT	0.666667	8	8	3061	1628	1433	25
22-10702227-G-A	0.083333	1	12	171	90	81	18
22-10702322-A-G	0.5	6	8	0	0	0	17
22-10702587-C-T	0.083333	1	12	2669	1224	1445	23
22-10702913-A-G	0.083333	1	12	6333	3245	3088	18
22-10703321-T-A	0.166667	2	12	NA	NA	NA	11
22-10703322-T-A	0.166667	2	10	0	0	0	10
22-10703772-A-G	0.5	6	10	1	1	0	16
22-10703848-G-T	0.666667	8	10	0	0	0	18
22-10703892-G-A	0.083333	1	12	2703	1371	1332	13
22-10704061-A-T	0.333333	4	12	1141	592	549	22
22-10704194-A-G	0.166667	2	12	3433	2009	1424	10
22-10705029-A-AAT	0.416667	3	6	3	2	1	12
22-10705448-G-A	0.333333	4	6	2924	1796	1128	20
22-10705488-T-C	0.666667	8	10	2648	1564	1084	28
22-10705593-T-C	0.666667	8	10	8279	4467	3812	34
22-10705606-G-C	0.75	9	12	8678	4680	3998	39
22-10705638-C-G	0.583333	7	10	7626	4030	3596	16
22-10705767-C-T	0.666667	8	8	13058	6839	6219	30
22-10705900-G-T	0.666667	8	12	10146	5336	4810	19
22-10705940-T-G	0.666667	8	10	12988	6827	6161	33
22-10705965-T-C	0.666667	8	8	11955	6302	5653	39
22-10706093-G-A	0.75	9	10	16430	8616	7814	32
22-10706099-G-A	0.75	9	12	8578	4683	3895	36
22-10706175-T-C	0.666667	8	10	7711	4174	3537	28
22-10706217-T-A	0.166667	2	10	33	20	13	12
22-10706266-T-G	0.416667	5	10	1054	615	439	19
22-10706416-G-T	0.666667	8	8	128	83	45	17
22-10706824-A-C	0.666667	8	10	0	0	0	20
22-10707315-ACT-A	0.5	5	8	5947	3102	2845	16
22-10707578-T-G	1	12	12	71566	36659	34907	43
22-10707616-A-G	0.833333	10	12	15504	8179	7325	41
22-10707820-T-G	0.583333	7	12	1849	1016	833	24
22-10707891-G-C	0.666667	8	8	3159	1804	1355	22
22-10708094-T-C	0.666667	8	10	9297	5034	4263	32
22-10708116-G-A	0.666667	8	10	10505	5597	4908	37
22-10708151-A-G	0.666667	8	10	11172	5901	5271	32
22-10708789-A-C	0.666667	8	10	12926	6835	6091	28
22-10708894-T-C	0.333333	4	8	4075	2116	1959	23
22-10709156-A-C	0.75	9	10	20564	10646	9918	34
22-10709259-C-CCT	0.416667	6	6	3833	2177	1656	17
22-10709329-T-A	0.5	6	8	9147	4969	4178	29
22-10709548-T-A	0.666667	8	8	52	18	34	28
22-10709619-C-T	0.166667	2	8	0	0	0	11
22-10709861-C-T	0.166667	2	10	21570	12246	9324	22
22-10710053-G-A	0.916667	11	12	11996	6359	5637	38
22-10710552-T-G	0.583333	7	8	353	166	187	22
22-10710605-G-T	0.666667	8	10	14311	7417	6894	51
22-10710615-A-T	0.666667	8	10	32013	16272	15741	46
22-10710661-G-GA	0.833333	10	12	2482	1284	1198	23
22-10710846-A-C	1	12	12	822	404	418	16
22-10710870-T-A	0.833333	10	10	3256	1693	1563	30
22-10710894-T-G	0.666667	8	8	16974	8773	8201	36
22-10710975-G-T	0.666667	8	12	14762	7627	7135	40
22-10710983-G-C	0.333333	4	8	0	0	0	18
22-10710995-GTTTT-G	0.666667	6	10	14603	7523	7080	17
22-10711045-G-T	0.666667	8	12	15269	7881	7388	32
22-10711082-C-T	0.833333	10	10	15305	7901	7404	42
22-10711152-A-G	0.333333	4	8	264	138	126	12
22-10711317-C-T	0.5	6	12	316	165	151	30
22-10711402-A-G	0.833333	10	10	25604	13008	12596	49
22-10711465-A-T	0.666667	8	8	16792	8649	8143	47
22-10711770-A-T	0.666667	8	8	16415	8430	7985	38
22-10711853-C-A	0.666667	8	8	332	161	171	16
22-10711964-T-C	0.666667	8	10	22796	11823	10973	46
22-10711980-A-G	0.666667	8	8	22450	11662	10788	32
22-10712065-T-C	0.833333	10	10	21439	11088	10351	47
22-10712274-C-G	0.166667	2	4	0	0	0	11
22-10712444-C-A	0.666667	8	10	26962	13935	13027	38
22-10712448-C-G	0.5	6	8	253	115	138	23
22-10712467-A-G	0.666667	8	8	26577	13805	12772	41
22-10712499-G-A	0.833333	10	12	25410	13211	12199	45
22-10712642-G-A	0.416667	4	8	266	130	136	12
22-10712720-A-G	0.75	9	10	26164	13491	12673	46
22-10712931-T-C	0.916667	11	12	24883	12915	11968	56
22-10713237-A-G	0.666667	8	8	263	144	119	14
22-10713334-C-A	0.666667	8	10	23692	12283	11409	44
22-10713339-A-G	0.666667	8	10	23132	11971	11161	35
22-10713373-T-C	0.666667	8	8	471	243	228	26
22-10713392-T-C	0.666667	8	8	28983	14734	14249	38
22-10713474-C-G	0.666667	8	10	32186	16462	15724	36
22-10713486-A-AG	0.666667	8	12	23207	12070	11137	33
22-10713561-A-G	0.666667	8	10	23248	12017	11231	30
22-10713652-C-A	1	12	12	76114	38926	37188	49
22-10713820-T-C	0.583333	7	12	214	103	111	15
22-10713908-G-A	0.833333	10	10	39296	20078	19218	44
22-10713971-A-G	0.666667	8	12	39661	20335	19326	34
22-10713974-A-C	0.666667	8	12	25740	13326	12414	28
22-10714037-G-A	0.583333	6	10	263	123	140	18
22-10714046-A-G	0.666667	8	8	24804	12983	11821	45
22-10714047-A-G	0.666667	8	8	24849	12999	11850	45
22-10714219-G-A	0.5	6	10	211	102	109	11
22-10714597-G-C	0.666667	8	8	25215	13055	12160	44
22-10714629-G-A	0.25	3	6	0	0	0	10
22-10714676-T-G	0.666667	8	8	25465	13137	12328	57
22-10714858-A-T	0.666667	8	8	23886	12417	11469	44
22-10715029-T-C	1	12	12	25160	13007	12153	52
22-10715236-G-A	0.75	9	10	26926	13852	13074	49
22-10715322-A-G	0.666667	8	8	26208	13517	12691	37
22-10715364-A-T	0.25	3	6	0	0	0	10
22-10715383-A-G	0.666667	8	10	23735	12261	11474	35
22-10715407-G-C	0.666667	8	12	22141	11452	10689	38
22-10715630-G-A	0.666667	8	8	401	193	208	20
22-10715743-G-T	0.666667	8	10	26244	13318	12926	23
22-10715837-G-A	0.833333	10	10	636	304	332	21
22-10715925-G-C	0.833333	10	12	15621	8092	7529	47
22-10716028-G-T	0.666667	8	8	16415	8530	7885	37
22-10716078-G-A	0.666667	8	12	19371	10047	9324	40
22-10716192-T-G	0.666667	8	8	266	127	139	17
22-10716233-A-AT	0.833333	10	10	27081	14043	13038	55
22-10716431-C-T	0.75	9	10	24924	12886	12038	43
22-10716520-G-A	0.333333	3	6	234	105	129	13
22-10716849-A-AT	0.666667	8	10	24271	12573	11698	25
22-10716882-T-C	0.666667	8	8	0	0	0	37
22-10716902-C-T	0.75	9	10	354	168	186	20
22-10716970-C-T	0.416667	5	7	2011	1030	981	16
22-10717098-T-C	0.75	9	10	5158	2743	2415	54
22-10717194-T-C	0.666667	8	8	6326	3238	3088	39
22-10717243-G-A	0.083333	1	4	0	0	0	10
22-10717362-C-A	0.5	6	8	4076	2120	1956	12
22-10717363-A-C	0.666667	8	10	10405	5439	4966	27
22-10717379-C-A	0.833333	10	12	11015	5729	5286	36
22-10717387-C-A	0.666667	8	8	10643	5535	5108	32
22-10717410-GTCCAT-G	0.416667	5	12	13	6	7	14
22-10717410-GTCCATTCCAT-G	0.416667	5	12	0	0	0	14
22-10717459-G-T	0.416667	5	10	10	7	3	12
22-10717498-C-A	0.166667	2	4	1	1	0	10
22-10717510-GTCCAT-G	0.583333	6	12	71	27	44	26
22-10717510-G-GTCCAT	0.416667	5	12	1	1	0	26
22-10717570-A-T	0.166667	2	4	0	0	0	12
22-10717878-C-T	0.083333	1	6	0	0	0	11
22-10717890-G-GTCCATTCCAT	0.833333	4	6	2874	1516	1358	11
22-10718140-G-A	0.5	6	6	1071	522	549	27
22-10718200-G-T	0.5	6	6	1909	975	934	12
22-10718323-A-C	0.666667	8	8	12790	6647	6143	37
22-10718355-GTCCAT-G	0.583333	7	10	300	136	164	11
22-10718453-A-G	0.666667	8	12	13182	6828	6354	20
22-10718508-C-A	0.666667	8	10	5525	2833	2692	21
22-10718584-G-A	0.666667	8	10	10208	5521	4687	28
22-10718605-G-T	0.583333	5	7	1176	613	563	14
22-10718607-A-C	0.583333	5	5	1228	644	584	24
22-10718620-A-T	0.666667	8	12	10580	5652	4928	25
22-10718727-C-T	0.5	6	8	3863	1998	1865	11
22-10718738-G-C	0.666667	8	12	12600	6618	5982	29
22-10718899-T-A	0.666667	8	10	1316	729	587	37
22-10718918-G-A	0.083333	1	12	1088	527	561	26
22-10718944-T-A	0.666667	8	10	3025	1641	1384	31
22-10719123-A-T	0.5	6	10	514	245	269	21
22-10719143-A-G	0.666667	8	10	1115	558	557	12
22-10719147-C-T	0.666667	8	10	1260	645	615	24
22-10719164-A-G	0.666667	8	12	8490	4412	4078	22
22-10719194-G-A	0.583333	7	12	12487	6472	6015	11
22-10719218-T-C	0.666667	8	12	10730	5536	5194	11
22-10719240-C-T	0.666667	8	12	829	415	414	10
22-10719399-T-A	0.666667	8	12	13654	7051	6603	27
22-10719456-A-T	0.666667	8	8	14075	7273	6802	47
22-10719602-A-C	0.666667	8	8	18468	9471	8997	36
22-10719882-C-CCATTCCATTT	0.5	6	12	0	0	0	11
22-10719914-C-A	0.666667	8	8	17524	9036	8488	29
22-10719987-T-C	0.666667	8	10	14464	7469	6995	21
22-10720027-G-GCATTC	0.666667	8	8	9346	4990	4356	23
22-10720060-C-T	0.416667	3	3	521	265	256	12
22-10720075-T-G	0.666667	8	8	12451	6511	5940	21
22-10720076-A-T	0.666667	8	8	12507	6539	5968	22
22-10720247-C-G	0.333333	3	10	74	33	41	12
22-10720311-A-G	0.666667	8	10	13773	7114	6659	23
22-10720384-T-A	0.666667	8	12	14530	7501	7029	31
22-10720418-T-C	0.416667	2	2	60	25	35	11
22-10720577-T-C	0.5	6	8	20783	10718	10065	14
22-10720630-C-G	0.666667	8	10	21441	10947	10494	35
22-10720636-T-C	0.666667	8	8	4175	2165	2010	31
22-10720657-GCATTCCATTC-G	0.583333	6	12	1	1	0	16
22-10720657-G-GCATTC	0.333333	4	12	2	0	2	16
22-10720758-T-C	0.666667	8	12	13460	6904	6556	38
22-10720790-G-T	0.666667	8	10	4046	2090	1956	28
22-10720812-G-C	0.666667	8	8	13318	6855	6463	31
22-10720928-C-CA	0.75	9	12	12064	6370	5694	29
22-10720936-T-C	0.666667	8	10	12049	6382	5667	41
22-10720941-G-A	0.083333	1	12	9	5	4	21
22-10721048-T-G	0.75	9	12	11890	6156	5734	32
22-10721543-C-A	0.666667	8	10	7879	4030	3849	12
22-10721716-C-G	0.666667	8	10	832	445	387	11
22-10721942-C-T	0.083333	1	12	1	1	0	13
22-10721982-T-C	0.75	9	12	15444	7789	7655	21
22-10721988-A-G	0.5	6	10	2558	1301	1257	17
22-10722024-T-C	0.666667	8	10	4154	2136	2018	23
22-10722036-C-G	0.25	3	6	1796	918	878	18
22-10722042-C-T	0.166667	2	4	1646	858	788	22
22-10722165-T-C	0.666667	8	10	12434	6582	5852	31
22-10722184-C-G	0.666667	8	10	9299	4974	4325	30
22-10722241-G-C	0.666667	8	12	12645	6626	6019	21
22-10722252-A-G	0.75	9	12	19752	10172	9580	24
22-10722357-G-C	0.583333	7	10	20	8	12	10
22-10722371-T-C	0.666667	8	8	14430	7493	6937	26
22-10722398-G-C	0.333333	4	10	205	97	108	24
22-10722435-C-A	0.666667	8	8	13451	6934	6517	32
22-10722445-G-C	0.666667	8	12	14129	7265	6864	38
22-10722456-G-C	0.666667	8	12	13950	7180	6770	22
22-10722526-T-C	0.666667	8	12	19086	9807	9279	17
22-10722582-A-C	0.666667	6	6	29819	15159	14660	14
22-10722598-G-A	0.666667	8	10	18569	9502	9067	29
22-10722606-C-T	0.833333	10	12	1244	600	644	26
22-10722613-G-A	0.75	9	10	27323	13809	13514	45
22-10722690-GCATTC-G	0.416667	5	6	0	0	0	10
22-10722789-T-C	0.416667	5	10	381	173	208	11
22-10722800-T-A	0.75	9	10	24122	12446	11676	56
22-10723198-TTCCATTCCATTTCACTCGTG-T	0.833333	2	2	1	1	0	16
22-10723296-C-G	0.5	6	8	1390	719	671	15
22-10723311-C-T	0.666667	8	12	1249	650	599	18
22-10723336-G-T	0.666667	8	12	905	494	411	21
22-10723346-C-CATTTG	0.666667	8	8	656	364	292	27
22-10723351-A-C	0.5	8	10	693	390	303	12
22-10723384-C-T	0.666667	8	10	1534	886	648	35
22-10723453-C-T	0.666667	8	10	5653	3122	2531	23
22-10723498-G-A	0.666667	8	8	4340	2245	2095	37
22-10723528-C-A	0.166667	2	4	1535	774	761	18
22-10723532-C-A	0.666667	6	6	13039	6890	6149	14
22-10723633-GTCCAT-G	0.416667	3	6	252	128	124	11
22-10723835-A-C	0.75	9	10	21522	10895	10627	42
22-10723845-G-C	0.75	3	4	11208	5675	5533	28
22-10723854-T-A	0.083333	1	12	0	0	0	14
22-10723866-C-A	0.25	3	8	150	71	79	10
22-10723873-T-A	0.416667	5	10	9	4	5	17
22-10724045-A-C	0.666667	8	8	13178	6772	6406	30
22-10724065-C-T	0.333333	4	8	843	413	430	17
22-10724066-A-G	0.666667	8	10	13582	7003	6579	27
22-10724232-T-A	0.666667	8	8	20275	10491	9784	47
22-10724381-C-T	0.666667	8	10	749	370	379	17
22-10724461-A-T	0.666667	8	10	1773	848	925	13
22-10724485-C-T	0.666667	8	12	2050	999	1051	11
22-10724497-T-A	0.666667	8	12	12427	6415	6012	37
22-10724502-A-G	0.5	6	10	2143	1061	1082	15
22-10724557-A-G	0.333333	4	8	557	278	279	11
22-10724577-T-A	0.666667	8	10	6391	3280	3111	20
22-10724604-G-T	0.666667	8	12	11876	6232	5644	14
22-10724671-T-C	0.75	9	12	12741	6616	6125	36
22-10724827-C-A	0.666667	8	12	10977	5553	5424	17
22-10724940-A-C	0.666667	8	10	6634	3687	2947	36
22-10724957-T-A	0.75	9	10	12388	6521	5867	35
22-10724998-A-T	0.666667	8	10	8078	4543	3535	32
22-10725006-C-A	0.416667	4	8	148	70	78	17
22-10725010-C-T	0.083333	1	6	1	0	1	10
22-10725153-G-C	0.333333	3	6	7	5	2	10
22-10725212-G-A	0.666667	8	12	8049	4389	3660	23
22-10725245-G-C	0.666667	8	12	10104	5304	4800	18
22-10725250-G-C	0.333333	4	8	1651	842	809	16
22-10725320-T-C	0.666667	8	10	18329	9417	8912	28
22-10725438-C-T	0.666667	8	10	13814	7133	6681	23
22-10725506-A-G	0.666667	8	10	11669	6032	5637	24
22-10725516-T-C	0.666667	8	10	11713	6040	5673	25
22-10725551-G-A	0.083333	1	12	34	17	17	12
22-10725560-G-C	0.666667	8	12	12872	6646	6226	28
22-10725580-C-G	0.666667	8	12	12159	6288	5871	16
22-10725616-C-T	0.666667	8	12	4650	2382	2268	21
22-10725663-T-G	0.666667	8	10	12815	6620	6195	41
22-10725763-C-T	0.666667	8	10	2487	1260	1227	21
22-10725840-T-C	0.666667	8	10	2884	1650	1234	16
22-10725926-TATTCC-T	0.083333	1	2	213	111	102	32
22-10726032-T-TTTCTA	0.333333	4	8	0	0	0	12
22-10726037-G-A	0.5	6	10	1	1	0	28
22-10726051-T-C	0.75	9	10	5828	3020	2808	36
22-10726257-T-A	0.166667	2	8	0	0	0	13
22-10726270-T-C	0.666667	8	10	98	57	41	12
22-10726515-C-G	0.5	6	10	1143	548	595	12
22-10726591-T-C	0.833333	10	12	12506	6479	6027	24
22-10726879-T-C	0.666667	8	12	3052	1624	1428	18
22-10726886-T-A	0.666667	8	12	10636	5488	5148	21
22-10726932-C-CTCCATTCCATTCAGT	0.333333	4	4	5335	2874	2461	17
22-10726981-T-A	0.666667	8	8	15850	8128	7722	31
22-10727077-G-A	0.75	9	10	88	38	50	22
22-10727114-T-C	0.666667	8	10	11310	5930	5380	34
22-10727121-G-A	0.666667	8	8	14284	7462	6822	34
22-10727151-G-A	0.666667	8	8	20612	10730	9882	37
22-10727171-T-A	0.666667	8	10	20534	10616	9918	39
22-10727199-G-C	0.666667	8	10	20411	10573	9838	41
22-10727204-C-A	0.083333	1	4	1	1	0	10
22-10727211-A-G	0.583333	7	10	231	104	127	23
22-10727238-T-C	0.583333	7	8	58	22	36	22
22-10727435-T-G	0.666667	8	8	14726	7585	7141	33
22-10727458-C-A	0.666667	8	10	13893	7137	6756	29
22-10727464-G-A	0.666667	8	8	750	361	389	33
22-10727468-A-C	0.666667	8	8	14084	7204	6880	34
22-10727473-T-C	0.666667	8	12	13790	7056	6734	32
22-10727499-C-G	0.333333	4	10	0	0	0	13
22-10727539-A-G	0.333333	4	8	1058	504	554	11
22-10727547-A-C	0.666667	8	8	20101	10438	9663	31
22-10727617-G-C	0.833333	10	10	19710	10203	9507	33
22-10727627-C-T	0.083333	1	4	190	84	106	12
22-10727672-G-A	0.166667	2	4	260	123	137	12
22-10727811-C-T	0.416667	5	8	209	92	117	25
22-10727822-T-C	0.666667	8	8	20064	10367	9697	45
22-10727896-G-C	0.666667	10	10	727	383	344	22
22-10727908-A-T	0.666667	8	8	169	88	81	15
22-10727982-A-C	0.666667	8	8	20061	10388	9673	52
22-10728103-A-T	0.916667	11	12	443	219	224	27
22-10728192-T-C	0.666667	8	8	13527	6996	6531	25
22-10728204-T-A	0.833333	10	10	13338	6882	6456	28
22-10728251-T-C	1	12	12	75283	38570	36713	45
22-10728252-G-A	0.666667	8	10	11568	6036	5532	36
22-10728343-A-G	0.666667	8	10	12670	6497	6173	23
22-10728364-T-C	0.666667	8	8	12577	6491	6086	32
22-10728389-T-A	0.333333	4	10	0	0	0	16
22-10728417-T-G	0.666667	8	10	4360	2288	2072	32
22-10728466-T-C	0.666667	8	10	12596	6459	6137	52
22-10728467-G-A	0.666667	8	8	12651	6466	6185	47
22-10728508-G-A	0.666667	8	8	15615	7781	7834	40
22-10728536-T-C	0.666667	8	8	7893	3971	3922	46
22-10728569-C-T	0.666667	8	8	14623	7295	7328	41
22-10728578-A-T	0.75	9	10	6969	3510	3459	38
22-10728626-A-C	0.5	6	6	4	3	1	25
22-10728631-A-C	0.666667	8	10	47	27	20	22
22-10728638-T-A	0.666667	8	8	19	12	7	26
22-10728683-AT-A	0.666667	8	12	5352	2675	2677	16
22-10728706-C-T	0.666667	8	8	5787	2891	2896	30
22-10728727-T-G	1	12	12	14819	7445	7374	38
22-10728733-A-G	0.833333	10	10	14898	7444	7454	46
22-10728837-T-C	0.666667	8	8	11902	6123	5779	36
22-10729068-C-A	0.666667	8	8	14193	7322	6871	32
22-10729141-A-C	0.666667	8	10	14692	7576	7116	51
22-10729146-A-C	0.666667	8	10	14721	7594	7127	42
22-10729157-G-A	0.083333	1	6	0	0	0	11
22-10729171-T-C	0.583333	3	3	2337	1156	1181	35
22-10729207-T-TATTCC	0.583333	7	11	19	6	13	24
22-10729323-T-G	0.666667	8	12	15117	7774	7343	12
22-10729358-A-G	0.833333	10	10	26052	13334	12718	24
22-10729366-G-C	0.833333	10	10	16333	8448	7885	31
22-10729375-T-A	0.416667	5	10	2	0	2	17
22-10729502-C-T	0.833333	10	12	893	453	440	23
22-10729506-A-G	0.666667	8	10	805	398	407	22
22-10729526-C-G	0.666667	8	8	1143	562	581	23
22-10729539-T-G	0.666667	8	8	16217	8374	7843	29
22-10729562-A-G	0.666667	8	10	15023	7703	7320	20
22-10729669-GTCCAT-G	0.833333	10	12	584	267	317	20
22-10729728-A-G	0.25	3	3	0	0	0	21
22-10729766-A-C	0.833333	10	10	26827	13928	12899	29
22-10729873-A-C	0.416667	5	10	10	3	7	14
22-10729896-C-G	0.666667	8	8	889	448	441	30
22-10729917-T-C	0.916667	11	12	21081	10886	10195	44
22-10729953-A-T	0.666667	8	8	5578	3018	2560	23
22-10730041-G-A	0.666667	8	8	18670	9591	9079	42
22-10730066-C-G	0.666667	8	10	1079	531	548	27
22-10730086-T-C	0.666667	8	12	21741	11238	10503	32
22-10730089-C-G	0.666667	8	10	28875	14747	14128	41
22-10730123-A-AG	0.666667	8	12	21887	11314	10573	37
22-10730190-C-T	0.5	6	12	204	104	100	10
22-10730193-A-G	0.833333	10	10	18572	9560	9012	28
22-10730255-C-A	0.666667	8	8	1319	647	672	20
22-10730306-G-C	0.666667	8	8	3762	1869	1893	27
22-10730330-C-G	0.25	3	8	2	1	1	10
22-10730363-C-T	0.666667	8	8	164	81	83	17
22-10730368-C-T	0.833333	10	10	10568	5206	5362	20
22-10730390-A-G	0.666667	8	8	23003	11945	11058	22
22-10730449-T-C	0.583333	6	8	374	179	195	19
22-10730529-A-C	0.666667	8	8	23295	12092	11203	49
22-10730625-C-A	0.666667	8	8	25919	13438	12481	58
22-10730655-G-C	0.416667	5	8	1174	608	566	25
22-10730664-T-C	1	12	12	31684	16214	15470	55
22-10730693-T-C	0.166667	2	6	0	0	0	13
22-10730791-G-A	0.5	6	8	3214	1645	1569	18
22-10730804-T-C	0.75	9	10	20940	10868	10072	49
22-10730991-A-G	0.666667	8	8	21082	10978	10104	49
22-10731221-C-T	0.166667	2	4	0	0	0	11
22-10731248-AAT-A	0.083333	1	6	0	0	0	10
22-10731396-C-A	0.833333	9	10	36400	18536	17864	46
22-10731564-TAAA-T	0.916667	12	12	19304	9699	9605	30
22-10731574-A-C	0.833333	10	10	22376	11417	10959	27
22-10731891-A-T	0.75	9	10	20297	10344	9953	23
22-10731898-T-C	0.666667	8	10	8435	4436	3999	39
22-10731964-T-A	0.75	9	10	18507	9588	8919	27
22-10732089-G-T	0.5	6	6	167	69	98	22
22-10732288-T-C	0.666667	8	8	12991	6713	6278	41
22-10732323-A-G	0.5	6	8	142	65	77	16
22-10732339-C-A	0.666667	8	8	13003	6721	6282	34
22-10732464-G-C	0.833333	10	10	0	0	0	16
22-10732684-A-G	0.666667	8	8	22826	11882	10944	37
22-10732704-G-T	0.666667	8	8	14	4	10	16
22-10732888-A-G	0.916667	11	12	34722	17653	17069	50
22-10733011-C-A	0.666667	8	8	24595	12656	11939	49
22-10733055-A-G	0.416667	5	8	226	106	120	11
22-10733102-G-A	0.666667	8	8	18644	9665	8979	54
22-10733214-A-G	0.666667	8	8	19991	10406	9585	37
22-10733258-G-C	0.333333	4	8	258	117	141	15
22-10733282-T-C	0.666667	8	10	263	122	141	13
22-10733773-A-G	0.666667	8	8	24462	12698	11764	35
22-10733847-C-T	0.666667	8	8	109	56	53	11
22-10733881-C-T	0.75	9	10	118	58	60	19
22-10734030-A-G	0.666667	8	8	32569	16669	15900	39
22-10734274-C-G	0.666667	8	8	27213	14179	13034	37
22-10734351-T-C	1	12	12	74236	37922	36314	45
22-10734384-A-G	0.833333	10	10	27553	14275	13278	43
22-10734392-T-C	0.75	9	10	39145	19969	19176	38
22-10734522-A-T	0.666667	8	10	18655	9651	9004	32
22-10734627-A-G	0.666667	8	8	17469	9007	8462	46
22-10734727-A-G	0.666667	8	8	21910	11369	10541	31
22-10734837-C-T	0.833333	10	10	40609	20707	19902	27
22-10735061-A-G	0.666667	8	8	25761	13277	12484	32
22-10735154-T-C	0.666667	8	8	24257	12539	11718	33
22-10735563-T-G	0.666667	8	8	40260	20530	19730	38
22-10735688-T-A	0.583333	6	8	221	107	114	17
22-10735859-C-CA	0.666667	8	8	17963	9307	8656	36
22-10735889-A-C	0.666667	8	8	15398	8007	7391	42
22-10736002-C-G	0.666667	8	10	14887	7680	7207	32
22-10736043-T-G	0.666667	8	10	15036	7800	7236	50
22-10736151-C-G	1	12	12	4733	2422	2311	13
22-10736191-A-C	0.666667	8	8	26474	13480	12994	35
22-10736399-T-C	0.166667	2	4	336	178	158	11
22-10736488-C-T	0.666667	8	8	1092	597	495	13
22-10736513-TA-T	0.333333	4	8	9	5	4	26
22-10736513-T-TA	0.083333	1	8	293	150	143	26
22-10736550-C-T	0.416667	5	10	0	0	0	12
22-10736607-A-G	0.833333	10	12	0	0	0	16
22-10736745-C-T	0.75	9	10	30534	15550	14984	44
22-10736872-T-C	0.75	9	10	27340	14235	13105	44
22-10737302-C-T	0.666667	8	8	24999	12737	12262	33
22-10737326-C-CCT	0.666667	8	12	11680	6059	5621	25
22-10737402-A-G	0.666667	8	8	380	180	200	19
22-10737497-T-A	0.666667	8	10	23274	12077	11197	27
22-10737567-C-T	0.5	6	8	4	2	2	21
22-10737722-C-CCACTCTAT	0.666667	8	8	13729	7161	6568	32
22-10737857-C-G	0.666667	8	10	6369	3292	3077	26
22-10737872-C-CA	0.666667	8	12	10462	5446	5016	25
22-10737874-G-T	0.583333	8	8	10399	5392	5007	19
22-10738422-G-A	0.833333	10	10	21423	11051	10372	41
22-10738429-T-G	0.666667	8	10	1065	547	518	21
22-10738545-C-A	0.5	6	6	16	6	10	19
22-10738814-AT-A	1	12	12	31823	16189	15634	25
22-10738819-T-A	0.666667	8	10	27495	14030	13465	28
22-10738833-T-C	0.75	8	10	22974	11833	11141	34
22-10739075-A-G	0.916667	11	12	29536	15271	14265	40
22-10739105-C-T	0.666667	8	8	490	247	243	16
22-10739159-G-A	0.666667	8	10	436	213	223	24
22-10739180-C-T	0.666667	8	10	37908	19372	18536	35
22-10739259-A-C	0.666667	8	12	22902	11808	11094	42
22-10739301-T-C	0.666667	8	8	22286	11485	10801	49
22-10739554-A-G	0.333333	4	10	0	0	0	17
22-10739666-A-AAT	0.583333	6	8	0	0	0	15
22-10739668-A-T	0.416667	7	7	0	0	0	27
22-10739688-T-C	0.666667	8	10	13339	6896	6443	24
22-10740048-T-C	0.75	9	10	34121	17312	16809	50
22-10740418-A-G	0.666667	8	8	18901	9876	9025	42
22-10740420-C-T	0.666667	8	8	19044	9936	9108	38
22-10740533-G-T	0.666667	8	10	25474	13211	12263	24
22-10740887-T-C	0.666667	8	12	14145	7279	6866	32
22-10740936-A-AT	0.666667	8	10	13172	6805	6367	40
22-10740976-C-G	0.5	6	8	91	34	57	13
22-10741059-C-T	0.666667	8	8	13663	7060	6603	42
22-10741089-T-C	0.666667	8	10	13878	7147	6731	32
22-10741219-G-T	0.666667	8	8	14909	7666	7243	32
22-10741320-A-T	0.666667	8	12	228	115	113	18
22-10741343-A-C	0.666667	8	8	18465	9486	8979	41
22-10741377-T-C	0.666667	8	8	18666	9659	9007	44
22-10741470-T-C	0.666667	8	10	17134	8883	8251	34
22-10741556-G-T	0.166667	2	12	0	0	0	22
22-10741562-T-C	0.666667	8	12	12765	6622	6143	10
22-10741566-A-G	0.666667	8	12	12666	6570	6096	11
22-10741604-T-C	0.666667	8	12	2329	1190	1139	33
22-10741611-G-C	0.666667	8	12	1728	904	824	35
22-10741621-A-G	0.666667	8	12	576	298	278	12
22-10741705-A-C	0.666667	8	12	20254	10313	9941	18
22-10741725-T-C	0.666667	8	10	20554	10463	10091	24
22-10741745-G-A	0.5	6	10	422	211	211	13
22-10741760-G-C	0.666667	8	12	14308	7417	6891	26
22-10741863-C-T	1	12	12	11802	6123	5679	24
22-10741994-A-C	0.666667	8	12	17258	8900	8358	25
22-10742002-C-G	0.583333	6	12	148	67	81	22
22-10742020-T-C	0.666667	8	10	30855	15805	15050	41
22-10742054-T-C	0.666667	8	10	22835	11886	10949	39
22-10742143-C-G	0.666667	8	12	16718	8624	8094	26
22-10742205-A-G	0.666667	8	12	13670	7032	6638	21
22-10742240-G-A	0.5	6	10	702	328	374	22
22-10742276-G-C	0.666667	8	12	15510	7998	7512	28
22-10742394-T-C	0.666667	8	8	26346	13357	12989	50
22-10742611-T-G	0.666667	8	10	16354	8426	7928	28
22-10742626-G-A	0.666667	8	12	15569	8004	7565	30
22-10742635-G-A	0.666667	8	10	29166	14853	14313	33
22-10742708-A-G	0.666667	8	12	20623	10684	9939	34
22-10742779-G-T	0.666667	8	8	23758	12311	11447	40
22-10742913-A-G	0.416667	5	8	15436	7950	7486	22
22-10742939-T-C	0.666667	8	8	17499	9121	8378	47
22-10743031-A-G	0.5	6	8	206	106	100	15
22-10743158-C-T	0.5	6	6	65	30	35	21
22-10743304-A-C	0.833333	10	10	26796	13772	13024	48
22-10743491-A-G	0.833333	10	10	24119	12207	11912	42
22-10743532-AAAAG-A	0.583333	6	9	1	0	1	19
22-10743571-A-G	0.583333	7	8	9637	4942	4695	46
22-10743640-T-C	0.666667	8	8	25849	13200	12649	35
22-10743728-G-A	0.666667	6	6	7809	4020	3789	34
22-10743829-G-T	0.666667	4	4	4332	2175	2157	26
22-10743857-T-G	0.666667	8	8	13445	6931	6514	36
22-10743923-C-G	0.666667	8	8	12859	6583	6276	36
22-10744175-T-A	0.666667	8	12	13683	7067	6616	26
22-10744190-G-A	0.666667	8	12	13472	6972	6500	21
22-10744192-T-G	0.333333	4	8	1742	889	853	10
22-10744511-T-C	0.666667	8	8	12637	6610	6027	23
22-10744516-C-T	0.666667	8	8	13817	7108	6709	18
22-10744598-T-C	0.666667	8	10	231	115	116	11
22-10744741-T-C	0.666667	8	12	16329	8479	7850	38
22-10744807-G-A	0.666667	8	10	6203	3068	3135	28
22-10744853-G-A	0.666667	8	8	13235	6837	6398	39
22-10744872-A-T	0.666667	8	8	20673	10499	10174	27
22-10744966-A-G	0.666667	8	10	13045	6749	6296	31
22-10744972-C-A	0.666667	8	12	12935	6689	6246	34
22-10744978-A-G	0.666667	8	10	13117	6790	6327	38
22-10744994-G-A	0.666667	8	8	13300	6860	6440	26
22-10745050-A-C	0.666667	8	12	13129	6782	6347	15
22-10745104-T-C	0.666667	8	10	13127	6783	6344	29
22-10745247-T-A	0.666667	8	12	11391	6054	5337	19
22-10745291-A-T	0.666667	8	12	1669	974	695	13
22-10745293-C-T	0.666667	8	12	1591	939	652	17
22-10745367-G-A	0.666667	8	12	7268	4151	3117	25
22-10745507-G-A	0.166667	1	12	0	0	0	18
22-10745521-C-G	0.083333	1	2	2	2	0	12
22-10745538-T-C	0.666667	8	8	10594	5717	4877	36
22-10745732-T-C	0.666667	8	10	27131	13905	13226	29
22-10745776-C-A	0.666667	7	8	143	71	72	11
22-10745779-T-C	0.666667	8	10	14599	7521	7078	36
22-10746060-A-G	0.666667	8	10	14025	7273	6752	38
22-10746154-T-C	0.666667	8	10	12728	6646	6082	38
22-10746187-T-TTTTG	0.5	8	8	1929	976	953	14
22-10746298-A-G	0.75	9	10	20468	10420	10048	44
22-10746352-G-T	0.666667	8	10	10436	5405	5031	29
22-10746424-G-C	0.666667	8	8	13217	6822	6395	24
22-10746486-T-C	0.666667	8	10	13144	6802	6342	41
22-10746636-A-G	0.833333	10	10	15657	8033	7624	33
22-10746653-T-G	0.666667	8	10	14969	7690	7279	34
22-10746769-T-A	0.666667	8	8	13210	6813	6397	31
22-10746809-T-C	0.666667	8	10	14137	7278	6859	27
22-10746830-T-TCTG	0.666667	8	10	13152	6814	6338	26
22-10747274-T-C	0.666667	8	8	25216	12913	12303	42
22-10747317-G-A	0.666667	8	8	21079	10698	10381	34
22-10747574-A-G	1	12	12	74573	38094	36479	41
22-10747597-A-G	1	12	12	72537	37121	35416	31
22-10748097-T-G	0.666667	8	10	24488	12636	11852	39
22-10748132-G-C	0.666667	8	10	207	93	114	15
22-10748411-C-CT	0.666667	8	8	16540	8599	7941	29
22-10748487-C-A	0.666667	8	8	71	34	37	20
22-10748604-T-C	0.666667	8	8	12675	6590	6085	28
22-10748606-G-GTGTC	0.666667	8	8	12538	6514	6024	27
22-10748640-C-G	0.666667	8	10	12532	6509	6023	18
22-10748900-A-G	0.666667	8	8	14276	7330	6946	34
22-10748925-T-C	0.833333	10	10	14042	7243	6799	42
22-10749021-C-A	0.666667	8	8	13327	6883	6444	40
22-10749024-C-A	0.833333	10	10	20952	10639	10313	48
22-10749047-G-A	0.75	9	10	13264	6860	6404	52
22-10749197-G-GT	0.583333	5	12	8818	4605	4213	16
22-10749198-G-T	0.666667	8	12	12004	6296	5708	34
22-10749209-G-T	0.666667	8	12	10343	5520	4823	26
22-10749268-T-C	0.666667	8	10	7376	4079	3297	29
22-10749309-T-C	0.666667	8	8	5170	2560	2610	18
22-10749802-A-C	0.666667	8	8	35712	18438	17274	36
22-10749872-C-G	0.833333	10	12	32958	17066	15892	36
22-10749992-T-G	0.5	5	6	19073	9814	9259	17
22-10750109-T-A	0.666667	8	10	34857	18037	16820	36
22-10750140-G-A	0.666667	8	12	33462	17335	16127	39
22-10750298-G-A	0.666667	8	8	25817	13099	12718	40
22-10750516-G-C	0.666667	8	8	15221	7858	7363	36
22-10750574-A-G	1	12	12	74679	38162	36517	29
22-10750587-G-A	0.166667	2	2	8449	4375	4074	11
22-10750720-C-CAAA	0.083333	1	7	47	25	22	15
22-10750720-C-CA	0.083333	1	7	720	341	379	15
22-10750989-C-T	0.666667	8	12	14222	7317	6905	24
22-10751023-AT-A	0.333333	4	8	6732	3439	3293	14
22-10751204-T-C	0.666667	8	8	14728	7577	7151	27
22-10751312-C-T	0.666667	8	12	13497	6968	6529	33
22-10751323-C-A	0.666667	8	8	21198	10755	10443	28
22-10751431-T-C	0.666667	8	8	21002	10686	10316	22
22-10751522-T-C	0.333333	4	10	4912	2522	2390	23
22-10751556-G-A	0.333333	4	8	12652	6565	6087	17
22-10751592-A-G	0.666667	7	10	3775	1922	1853	38
22-10751606-C-T	0.666667	8	8	12589	6534	6055	44
22-10751905-C-G	0.666667	8	8	14244	7344	6900	25
22-10752085-C-G	0.75	9	10	20993	11016	9977	26
22-10752322-A-T	1	12	12	74483	38066	36417	44
22-10752578-T-C	0.666667	8	8	38267	19728	18539	21
22-10752838-A-G	0.666667	8	8	20734	10664	10070	34
22-10752976-A-G	0.666667	8	8	27933	14534	13399	36
22-10753052-G-A	0.5	6	8	8693	4434	4259	27
22-10753172-C-G	0.333333	4	10	5997	3034	2963	39
22-10753180-G-T	0.333333	2	10	0	0	0	10
22-10753216-G-A	0.333333	4	6	5227	2654	2573	31
22-10753217-C-G	0.666667	8	8	13411	6920	6491	40
22-10753314-G-A	0.333333	4	10	7958	4007	3951	32
22-10753324-A-ATT	0.333333	4	8	7820	3973	3847	21
22-10753358-C-T	0.333333	4	10	18106	9308	8798	26
22-10753358-C-A	0.166667	2	10	0	0	0	26
22-10753466-A-G	0.333333	4	10	24207	12447	11760	25
22-10753544-C-T	0.166667	2	8	12613	6452	6161	18
22-10753605-A-G	0.166667	2	6	9504	4899	4605	27
22-10753757-T-G	0.333333	4	4	14501	7518	6983	36
22-10753877-T-G	0.666667	8	8	30054	15590	14464	44
22-10754037-A-G	0.666667	8	8	24974	12937	12037	41
22-10754243-T-G	0.666667	8	10	30094	15612	14482	39
22-10754254-T-G	0.5	6	10	70	37	33	18
22-10754330-C-T	0.333333	4	4	1	1	0	10
22-10754700-T-C	0.416667	5	8	8884	4497	4387	19
22-10754701-G-T	0.333333	4	8	5384	2752	2632	21
22-10754752-G-A	0.166667	1	6	2	0	2	14
22-10754757-T-TACA	0.75	9	10	13067	6698	6369	21
22-10755030-G-C	0.666667	8	8	18763	9639	9124	32
22-10755262-T-A	0.666667	8	10	27510	14111	13399	28
22-10755517-C-T	0.666667	8	8	472	254	218	15
22-10755546-A-C	0.833333	10	12	29	13	16	24
22-10755554-T-C	0.833333	10	12	29129	15061	14068	38
22-10755555-G-A	0.333333	4	4	63	29	34	21
22-10755594-G-A	0.5	6	8	439	229	210	13
22-10755640-G-A	0.666667	8	8	40489	20627	19862	44
22-10755663-G-A	0.666667	8	8	123	57	66	16
22-10755841-T-C	0.333333	4	10	1848	877	971	10
22-10755876-G-A	0.333333	4	6	10140	5142	4998	39
22-10756003-GT-G	0.666667	6	6	12485	6440	6045	24
22-10756101-A-ACAC	0.333333	4	10	4276	2242	2034	14
22-10756211-A-G	0.333333	4	8	1720	847	873	23
22-10756215-C-T	0.666667	8	10	13063	6760	6303	31
22-10756262-C-A	0.5	6	10	2146	1071	1075	20
22-10756388-T-C	0.333333	4	6	4819	2487	2332	19
22-10756438-G-A	0.333333	4	6	3602	1981	1621	24
22-10756451-A-G	0.333333	4	6	3752	2063	1689	31
22-10756467-C-T	0.333333	4	10	9	2	7	16
22-10756492-A-T	0.333333	4	10	4822	2472	2350	12
22-10756646-A-C	0.666667	8	10	24146	12366	11780	28
22-10756661-C-G	0.166667	2	10	2	1	1	13
22-10756673-G-A	0.666667	8	12	12449	6480	5969	37
22-10756830-A-G	0.333333	4	10	5604	2862	2742	28
22-10756905-C-T	0.666667	8	8	15234	7830	7404	24
22-10756987-C-A	0.333333	4	8	5316	2702	2614	25
22-10757250-T-C	0.333333	4	8	3933	2049	1884	34
22-10757346-C-T	0.583333	3	5	5225	2840	2385	10
22-10757400-T-C	0.666667	8	12	15196	7851	7345	33
22-10757547-G-A	0.583333	7	8	7929	4039	3890	21
22-10757585-T-C	0.666667	8	12	27334	13953	13381	30
22-10757592-A-G	0.583333	7	10	224	103	121	13
22-10757648-A-G	1	12	12	23027	11626	11401	23
22-10757650-G-A	0.666667	8	10	8649	4304	4345	21
22-10757742-A-T	0.833333	10	10	24472	12333	12139	19
22-10757751-C-A	1	12	12	71675	36678	34997	34
22-10757810-TTAAAC-T	0.333333	4	6	739	406	333	16
22-10757830-C-T	0.333333	4	4	5489	2838	2651	11
22-10757917-A-C	0.666667	8	8	22437	11363	11074	18
22-10757925-G-A	0.333333	4	8	5493	2797	2696	17
22-10757937-C-T	0.333333	4	10	5419	2765	2654	17
22-10757999-A-T	0.666667	8	10	21754	11013	10741	36
22-10758033-C-A	0.5	6	6	1844	971	873	27
22-10758047-G-C	0.666667	8	8	1962	1038	924	18
22-10758172-C-A	0.666667	8	10	4678	2426	2252	22
22-10758189-T-G	0.833333	10	10	24586	12414	12172	42
22-10758233-C-A	0.333333	4	6	5192	2690	2502	36
22-10758346-G-A	0.666667	8	8	16580	8565	8015	39
22-10758394-C-G	0.666667	8	8	16657	8584	8073	34
22-10758449-C-CT	0.333333	4	4	6933	3547	3386	34
22-10758595-G-A	0.416667	5	8	5302	2697	2605	31
22-10758610-T-C	0.5	6	10	6735	3451	3284	36
22-10758621-C-A	0.583333	8	8	4233	2189	2044	38
22-10758739-G-T	0.75	9	10	25099	12764	12335	47
22-10758944-A-G	0.25	3	4	2180	1129	1051	13
22-10759004-A-AC	0.666667	8	8	24792	12689	12103	21
22-10759114-A-G	0.666667	8	10	1722	862	860	22
22-10759129-T-C	0.666667	8	10	13263	6854	6409	32
22-10759260-A-C	0.666667	8	10	20530	10448	10082	41
22-10759317-A-T	0.666667	8	12	2877	1320	1557	21
22-10759454-T-C	0.666667	8	12	14111	7291	6820	33
22-10759493-T-A	0.666667	8	12	14616	7592	7024	32
22-10759500-A-G	0.666667	8	12	15211	7838	7373	29
22-10759526-A-G	0.666667	8	10	23512	11936	11576	33
22-10759859-T-A	0.666667	8	8	16642	8609	8033	42
22-10759866-G-T	0.666667	8	8	3698	1948	1750	26
22-10760154-G-A	0.5	6	8	75	44	31	14
22-10760182-T-C	0.666667	8	8	43	25	18	18
22-10760674-C-T	0.666667	8	8	38599	19692	18907	24
22-10760681-A-C	0.666667	8	8	22772	11858	10914	18
22-10760820-G-C	0.666667	8	12	24619	12615	12004	15
22-10760835-C-CAG	0.666667	8	12	12581	6529	6052	19
22-10760973-G-A	0.333333	4	6	9371	4794	4577	32
22-10761029-G-A	0.333333	4	8	5882	3075	2807	37
22-10761181-G-A	0.333333	4	10	3415	1844	1571	13
22-10761203-G-C	0.333333	4	10	1643	914	729	26
22-10761216-A-G	0.833333	10	12	20942	10881	10061	39
22-10761248-T-A	0.666667	8	8	17418	9010	8408	34
22-10761550-C-T	0.333333	4	12	8044	4050	3994	23
22-10761616-G-A	0.5	6	12	18463	9418	9045	31
22-10761667-A-T	0.083333	1	4	0	0	0	12
22-10761762-T-C	0.333333	4	10	14003	7200	6803	31
22-10762089-T-C	0.5	6	8	153	68	85	22
22-10762089-T-G	0.166667	2	8	5287	2703	2584	22
22-10762094-G-T	0.166667	2	6	2	1	1	11
22-10762201-C-T	0.833333	10	10	6848	3467	3381	35
22-10762358-A-AAAT	0.333333	4	8	58	27	31	13
22-10762381-C-T	0.333333	4	12	2600	1384	1216	18
22-10762382-G-A	0.333333	4	10	2735	1457	1278	26
22-10762391-G-A	0.333333	4	12	3740	1986	1754	30
22-10762415-A-G	0.333333	4	12	4536	2363	2173	25
22-10762442-C-T	0.333333	4	12	4680	2439	2241	27
22-10762463-A-T	0.333333	4	12	1996	1002	994	17
22-10762645-C-T	0.666667	8	10	9755	5245	4510	19
22-10762700-C-A	0.666667	8	12	1323	817	506	15
22-10762703-G-T	0.083333	1	4	2490	1165	1325	38
22-10762721-A-G	0.666667	8	10	6888	3870	3018	25
22-10763030-T-TAACTC	0.75	9	10	12823	6644	6179	22
22-10763646-T-A	0.666667	8	12	15552	8068	7484	26
22-10763680-G-A	0.666667	8	12	15886	8237	7649	43
22-10763834-T-A	0.666667	8	8	26538	13406	13132	40
22-10764266-C-T	0.583333	7	10	7697	3942	3755	33
22-10764294-G-A	0.666667	8	10	13135	6816	6319	45
22-10764321-CA-C	0.666667	8	12	14061	7272	6789	38
22-10764381-AG-A	0.416667	5	8	240	123	117	32
22-10764425-A-G	1	12	12	74064	37876	36188	56
22-10764434-T-G	0.666667	8	8	25427	13036	12391	54
22-10764653-C-T	0.666667	8	10	11809	6179	5630	47
22-10764676-C-T	0.666667	8	10	11675	6129	5546	47
22-10764707-G-T	0.666667	8	8	12342	6431	5911	47
22-10764867-C-T	0.666667	8	8	13949	7201	6748	31
22-10765053-T-C	0.25	3	6	384	182	202	12
22-10765151-C-A	0.666667	8	10	13810	7076	6734	30
22-10765158-A-T	0.666667	8	10	20561	10481	10080	31
22-10766037-A-G	0.666667	8	8	19685	10025	9660	37
22-10766069-C-A	0.083333	1	12	0	0	0	10
22-10766242-T-C	0.25	3	8	606	378	228	30
22-10766245-A-G	0.75	9	10	1970	1076	894	30
22-10766387-A-C	0.666667	8	8	9337	5192	4145	34
22-10766894-A-G	0.666667	8	12	14674	7498	7176	32
22-10766900-G-C	0.666667	8	12	14658	7512	7146	28
22-10766915-C-A	0.333333	4	8	223	119	104	10
22-10767025-C-T	0.666667	8	8	22687	11699	10988	38
22-10767089-A-G	1	12	12	71616	36614	35002	27
22-10767134-A-G	0.666667	8	8	17951	9289	8662	45
22-10767157-T-C	0.833333	10	12	11384	5933	5451	22
22-10767280-T-G	0.666667	8	8	18312	9393	8919	33
22-10767360-T-TAAA	0.25	3	6	5	3	2	19
22-10767360-T-TAA	0.083333	1	6	0	0	0	19
22-10767369-A-AAAAT	0.583333	7	10	10	5	5	12
22-10767537-A-T	0.75	9	10	19973	10332	9641	25
22-10767682-A-T	0.333333	3	6	215	104	111	12
22-10767761-A-G	0.666667	8	8	28079	14234	13845	26
22-10768001-G-A	0.666667	8	8	17387	8944	8443	49
22-10768620-C-CTGAAA	0.666667	8	8	24646	12482	12164	31
22-10768836-A-T	0.666667	8	8	21706	11209	10497	37
22-10768967-C-A	0.5	5	6	623	337	286	11
22-10768975-A-C	0.666667	8	8	17731	9148	8583	48
22-10769074-A-G	0.75	9	10	35195	18011	17184	36
22-10769237-T-A	0.833333	10	12	16465	8520	7945	48
22-10769333-ATATATATATATATATATTTTTT-A	0.166667	1	2	0	0	0	13
22-10769349-ATTTTTTTTTTTTTT-A	0.083333	1	2	2	2	0	13
22-10769398-T-C	0.666667	8	8	17822	9148	8674	23
22-10769413-A-G	0.666667	8	8	33052	16839	16213	20
22-10769470-A-G	0.666667	8	10	16884	8712	8172	39
22-10769479-T-C	0.666667	8	8	25730	13075	12655	39
22-10769642-T-C	0.75	9	10	27079	13680	13399	39
22-10770024-T-C	0.666667	8	8	13032	6736	6296	36
22-10770144-T-C	0.666667	8	8	20217	10296	9921	45
22-10770170-A-G	0.166667	2	6	0	0	0	10
22-10770247-T-C	0.666667	8	8	20708	10520	10188	38
22-10770803-T-C	0.666667	8	8	13807	7135	6672	41
22-10771257-T-C	0.666667	8	8	943	480	463	31
22-10771258-T-A	0.333333	4	6	NA	NA	NA	14
22-10771259-C-A	0.166667	2	4	0	0	0	18
22-10771491-T-C	0.666667	8	12	32287	16420	15867	30
22-10772295-A-G	0.666667	8	8	29482	15346	14136	31
22-10772380-T-C	0.666667	8	12	13682	7078	6604	24
22-10772470-G-A	0.666667	8	8	26724	13601	13123	34
22-10772728-G-A	0.5	6	8	0	0	0	21
22-10772730-C-A	0.333333	4	4	0	0	0	19
22-10772763-A-G	0.833333	10	12	23836	12305	11531	23
22-10772942-C-T	0.416667	5	6	3768	1946	1822	13
22-10772963-CA-C	0.583333	7	8	9954	5100	4854	36
22-10773128-C-T	0.666667	8	8	24749	12576	12173	39
22-10773671-A-G	0.166667	2	6	9316	4884	4432	14
22-10774108-G-T	0.416667	5	6	19406	9790	9616	33
22-10774353-C-A	0.666667	8	8	12970	6688	6282	25
22-10774379-AT-A	0.333333	4	4	5875	2990	2885	24
22-10774433-T-C	1	12	12	73679	37641	36038	42
22-10774574-A-G	0.5	6	10	6300	3234	3066	17
22-10774586-G-T	0.666667	8	8	12657	6577	6080	44
22-10774743-C-G	0.75	9	10	13550	7185	6365	38
22-10774768-G-A	0.666667	8	10	111	64	47	27
22-10775047-T-A	0.666667	8	8	37619	19290	18329	44
22-10775051-C-T	0.166667	2	6	11739	5982	5757	17
22-10775079-C-T	0.166667	2	4	0	0	0	11
22-10775093-TG-T	0.166667	2	8	0	0	0	19
22-10775105-C-T	0.5	6	8	1	0	1	35
22-10775145-G-A	0.666667	8	8	23504	12199	11305	45
22-10775250-T-C	0.666667	8	8	40592	20713	19879	35
22-10775268-A-G	0.666667	8	10	1	1	0	16
22-10775320-T-C	0.666667	8	10	19787	10357	9430	45
22-10775373-GA-G	0.416667	5	8	0	0	0	10
22-10775447-G-A	0.666667	8	10	45111	23225	21886	36
22-10775556-A-G	0.75	9	12	31669	16521	15148	34
22-10775576-A-G	0.833333	10	12	40708	20914	19794	31
22-10775703-A-G	0.666667	8	8	31246	16245	15001	49
22-10775724-A-C	0.166667	1	2	1	0	1	10
22-10775751-A-G	0.75	9	10	27818	14306	13512	45
22-10775753-T-C	0.333333	4	10	6	3	3	17
22-10775772-AC-A	0.333333	4	8	0	0	0	15
22-10775888-T-TA	0.5	6	8	697	357	340	33
22-10776057-TTTTTTTTTTTTA-T	0.833333	1	1	231	81	150	20
22-10776081-C-G	0.916667	11	12	31736	16507	15229	41
22-10776199-A-G	0.25	3	4	16839	8682	8157	22
22-10776310-G-A	0.416667	5	10	2	0	2	15
22-10776324-C-T	0.5	6	12	1	0	1	17
22-10776408-C-T	0.25	3	6	0	0	0	10
22-10776410-C-T	0.666667	8	8	41635	21340	20295	43
22-10776446-A-G	0.833333	10	10	222	102	120	46
22-10776570-A-C	0.666667	8	10	33266	17263	16003	39
22-10776592-T-C	0.833333	10	10	15439	8016	7423	40
22-10776600-A-C	0.833333	10	12	34790	17995	16795	47
22-10776603-C-T	0.833333	10	12	39825	20521	19304	47
22-10776625-A-T	0.5	6	12	115	49	66	24
22-10776628-CAAA-C	0.166667	3	4	2	1	1	10
22-10776727-G-A	0.5	6	12	0	0	0	21
22-10776797-A-AAAAT	0.833333	10	10	3423	1713	1710	20
22-10777314-C-CA	0.333333	4	6	18802	9704	9098	34
22-10777362-T-C	0.333333	4	4	17529	9054	8475	41
22-10777427-A-G	0.333333	4	4	2	0	2	10
22-10777479-A-C	0.416667	5	10	0	0	0	13
22-10777489-A-T	0.25	3	6	0	0	0	15
22-10777490-A-T	0.333333	4	8	0	0	0	21
22-10777497-T-G	1	12	12	40887	20666	20221	47
22-10777499-G-A	0.416667	5	10	1	0	1	16
22-10777594-T-C	0.416667	5	6	7687	3883	3804	38
22-10777616-T-C	0.166667	2	4	9459	4826	4633	11
22-10777782-G-C	0.5	6	10	18747	9485	9262	40
22-10777831-T-C	0.333333	4	4	8	1	7	11
22-10777833-A-G	0.5	6	8	14363	7426	6937	40
22-10778006-G-A	0.666667	8	8	1	0	1	19
22-10778077-A-T	0.166667	2	6	0	0	0	15
22-10778079-A-T	0.416667	4	10	6084	2952	3132	29
22-10778112-T-A	0.416667	5	8	118	52	66	14
22-10778127-T-A	0.333333	4	8	11970	6148	5822	25
22-10778141-A-ATG	0.333333	4	6	13402	6919	6483	18
22-10778152-T-C	0.333333	4	8	13063	6692	6371	23
22-10778153-G-A	0.25	3	8	2	0	2	13
22-10778207-C-A	0.666667	8	10	32598	16682	15916	23
22-10778264-G-A	0.416667	5	6	8330	4320	4010	47
22-10778267-T-C	0.583333	7	10	8108	4190	3918	43
22-10778319-CTTTTTGTATCAAACAAAAACTT-C	0.416667	5	7	0	0	0	15
22-10778428-C-G	0.333333	4	10	16728	8627	8101	22
22-10778537-GAAA-G	0.333333	4	6	0	0	0	16
22-10778555-A-C	0.5	6	6	21655	10964	10691	36
22-10778598-C-A	0.333333	4	4	2	1	1	14
22-10778602-A-C	0.333333	4	6	12231	6249	5982	36
22-10778684-C-G	0.333333	4	10	16636	8477	8159	14
22-10778714-A-T	0.416667	5	10	20557	10515	10042	26
22-10778729-T-C	0.666667	8	8	30691	15675	15016	45
22-10778776-C-T	0.083333	1	12	0	0	0	10
22-10778782-A-T	0.666667	8	8	36068	18405	17663	47
22-10778892-G-A	0.333333	4	8	0	0	0	19
22-10778922-A-G	0.583333	7	10	14556	7359	7197	39
22-10778961-T-C	0.333333	3	6	754	349	405	17
22-10779024-T-C	0.416667	5	6	12789	6661	6128	39
22-10779121-T-A	0.666667	8	8	13735	7158	6577	36
22-10779181-T-G	0.333333	4	8	12708	6632	6076	38
22-10779246-T-G	0.333333	4	4	2782	1422	1360	34
22-10779367-T-C	0.333333	4	4	14065	7309	6756	48
22-10779453-G-A	0.666667	8	8	0	0	0	12
22-10779528-C-T	0.5	6	10	88	44	44	14
22-10779533-A-G	0.333333	4	8	16189	8388	7801	38
22-10779554-A-C	0.416667	5	6	1	1	0	16
22-10779576-A-C	0.333333	4	4	17419	8985	8434	43
22-10779902-C-T	0.333333	4	8	0	0	0	14
22-10779921-A-G	0.916667	10	12	40329	20685	19644	51
22-10779990-A-T	0.583333	7	8	13618	7059	6559	37
22-10780286-G-A	0.333333	4	12	0	0	0	12
22-10780385-T-C	0.5	6	6	20597	10654	9943	47
22-10780663-C-T	0.916667	10	12	43331	22169	21162	53
22-10780714-G-A	0.833333	10	10	19498	10001	9497	50
22-10780751-CA-C	0.083333	1	2	1	1	0	13
22-10781041-CAAAAA-C	0.25	3	8	0	0	0	14
22-10781095-G-A	0.333333	4	8	5	3	2	13
22-10781425-C-A	0.166667	2	4	0	0	0	12
22-10781442-C-CAA	0.583333	7	7	9373	4711	4662	23
22-10781468-T-G	0.5	5	6	24665	12268	12397	43
22-10781479-G-A	0.166667	2	6	1	0	1	14
22-10781500-A-G	0.5	6	10	24578	12224	12354	31
22-10781537-A-G	0.333333	4	12	15207	7862	7345	28
22-10781548-C-T	0.166667	2	12	0	0	0	10
22-10781748-A-G	0.416667	5	10	0	0	0	16
22-10781793-G-A	0.333333	4	8	0	0	0	13
22-10782045-A-T	0.333333	4	6	11291	5880	5411	49
22-10782082-C-T	0.5	5	10	8	4	4	14
22-10782115-T-A	0.666667	8	8	12440	6449	5991	47
22-10782145-A-G	0.25	3	6	1	0	1	21
22-10782175-A-AT	0.416667	5	10	4	3	1	24
22-10782205-T-C	0.25	3	6	4	3	1	10
22-10782259-A-C	0.5	6	8	13060	6757	6303	42
22-10782292-A-G	0.5	6	6	18026	9119	8907	42
22-10782388-C-T	0.166667	2	6	1	1	0	11
22-10782396-T-C	0.416667	4	8	0	0	0	14
22-10782424-G-T	0.25	3	8	0	0	0	22
22-10782662-AG-A	0.25	3	6	0	0	0	16
22-10782669-G-A	0.5	6	6	20207	10291	9916	47
22-10782679-T-C	0.333333	4	4	15278	7901	7377	50
22-10782680-G-A	0.5	6	8	0	0	0	37
22-10782694-G-A	0.416667	5	10	0	0	0	15
22-10782711-G-C	0.5	6	6	19704	9976	9728	46
22-10782723-T-C	0.25	3	10	0	0	0	12
22-10782867-C-T	1	12	12	75054	38384	36670	47
22-10782918-C-G	0.333333	4	4	3	1	2	45
22-10783014-A-G	0.666667	8	8	39163	20076	19087	48
22-10783035-C-T	0.5	5	6	28079	14200	13879	40
22-10783118-G-A	0.416667	5	10	0	0	0	20
22-10783125-G-A	0.166667	2	6	1	1	0	23
22-10783128-C-CT	0.25	3	6	0	0	0	15
22-10783536-T-A	0.5	6	6	10690	5493	5197	38
22-10783595-A-C	0.333333	4	12	6725	3432	3293	40
22-10783612-C-T	0.416667	5	10	9931	4970	4961	26
22-10783613-T-C	0.25	3	8	9095	4545	4550	19
22-10783617-A-AG	0.5	6	8	10010	5025	4985	18
22-10783655-T-C	0.333333	4	10	7902	4002	3900	28
22-10783673-A-G	0.333333	4	10	9309	4747	4562	31
22-10783737-TCA-T	0.416667	3	7	11	7	4	13
22-10783738-CA-C	0.333333	4	7	4	3	1	13
22-10783788-A-G	0.416667	5	6	18133	9161	8972	50
22-10783792-A-G	0.5	6	8	20638	10463	10175	53
22-10783830-G-A	0.333333	4	8	731	356	375	18
22-10783945-T-G	0.666667	8	10	23054	11745	11309	47
22-10784165-T-C	0.666667	8	8	21855	11119	10736	45
22-10835288-C-T	0.166667	2	2	2	1	1	20
22-10835487-C-CAT	0.333333	4	6	359	199	160	11
22-10841234-G-A	0.333333	4	12	301	154	147	23
22-10842513-T-TTC	0.666667	8	12	19	9	10	15
22-10842513-T-TTTC	0.333333	4	12	3	0	3	15
22-10842515-G-C	1	12	12	36	15	21	16
22-10845243-T-C	0.75	9	10	8837	4649	4188	22
22-10845396-T-G	0.75	9	10	14991	7760	7231	16
22-10845732-G-A	0.5	6	8	568	303	265	20
22-10848611-A-G	0.5	6	10	0	0	0	15
22-10850228-T-G	0.75	9	10	6759	3692	3067	32
22-10850308-G-A	0.75	9	10	435	248	187	41
22-10850340-C-A	0.5	6	12	84	40	44	28
22-10850601-G-A	0.083333	1	12	5	4	1	10
22-10850757-G-GA	0.25	2	6	155	81	74	13
22-10850757-GAA-G	0.25	3	6	1088	560	528	13
22-10850799-G-A	0.083333	1	10	43	28	15	12
22-10851003-T-C	0.25	3	6	682	364	318	22
22-10851123-G-C	0.333333	4	12	0	0	0	24
22-10851244-A-G	0.75	9	12	3106	1602	1504	19
22-10851631-GAAAA-G	0.5	7	9	66	41	25	20
22-10851631-GAAA-G	0.25	2	9	29	17	12	20
22-10851738-A-G	1	12	12	2888	1456	1432	21
22-10851905-T-C	1	12	12	50798	26353	24445	37
22-10852063-A-C	0.333333	4	8	150	80	70	21
22-10852464-G-A	0.416667	4	6	373	192	181	10
22-10852515-T-C	0.666667	8	8	10828	5684	5144	26
22-10856485-C-T	0.166667	2	12	1	1	0	11
22-10856632-T-C	0.25	3	8	5	1	4	13
22-10856755-A-C	0.833333	10	10	1	0	1	13
22-10856757-C-T	0.666667	8	12	0	0	0	13
22-10860915-A-G	0.666667	8	8	2104	1107	997	30
22-10861045-A-G	0.5	6	6	1348	690	658	10
22-10861103-T-A	0.333333	4	8	487	234	253	20
22-10861183-T-C	0.333333	4	12	133	73	60	22
22-10861239-A-G	0.5	6	6	597	296	301	28
22-10861271-C-T	0.166667	2	4	0	0	0	14
22-10862724-T-C	0.666667	8	12	140	73	67	28
22-10862818-G-T	0.666667	8	12	328	163	165	18
22-10862825-A-G	0.5	6	10	405	203	202	20
22-10862950-G-A	0.166667	2	12	15	10	5	20
22-10862972-GA-G	0.25	2	12	17	8	9	15
22-10863235-C-T	0.25	3	12	516	294	222	19
22-10863409-GC-G	0.166667	2	12	0	0	0	11
22-10865935-G-A	0.5	6	10	1	0	1	12
22-10868771-TATATATACACAC-T	0.25	3	5	2731	1515	1216	17
22-10869646-G-A	0.333333	3	12	35	11	24	17
22-10869739-C-T	0.333333	3	10	170	86	84	11
22-10869905-C-CAT	0.333333	4	12	4401	2268	2133	25
22-10870045-G-C	0.333333	4	12	133	62	71	13
22-10924608-A-G	0.5	6	12	18	9	9	13
22-10925525-G-C	0.166667	2	4	0	0	0	12
22-10926206-G-A	0.916667	11	12	68223	35017	33206	45
22-10928166-C-CCCTT	0.416667	5	10	2033	1063	970	16
22-10928200-T-TTTCC	0.25	3	7	97	52	45	18
22-10928536-T-C	0.916667	11	12	67918	34832	33086	58
22-10931988-A-G	0.416667	5	6	23090	11528	11562	43
22-10932660-A-G	0.5	6	12	13	3	10	23
22-10933172-A-T	1	12	12	75033	38420	36613	60
22-10935679-A-G	0.083333	1	12	0	0	0	17
22-10935917-G-A	0.5	6	12	0	0	0	27
22-10936816-C-G	0.5	6	12	17302	8947	8355	17
22-10938373-T-C	0.5	6	12	16	4	12	13
22-10939063-C-T	0.25	3	6	18154	9401	8753	11
22-10939650-G-A	0.333333	4	10	0	0	0	16
22-10940978-G-A	0.166667	2	12	0	0	0	11
22-10943532-A-T	0.333333	4	12	0	0	0	11
22-10947001-C-T	0.583333	7	12	30916	15715	15201	41
22-10948307-T-C	1	12	12	74944	38380	36564	66
22-10948470-T-C	0.25	3	6	18154	9405	8749	13
22-10950864-A-G	0.5	6	12	13	4	9	49
22-10953613-CA-C	0.083333	1	2	0	0	0	14
22-10953925-T-A	0.5	6	10	30899	15701	15198	54
22-10955178-G-A	0.333333	4	8	13	3	10	15
22-10955458-A-AG	0.083333	1	7	0	0	0	12
22-10955828-GA-G	0.166667	2	10	0	0	0	16
22-10955996-CT-C	0.166667	2	4	7	3	4	24
22-10958095-T-C	0.5	6	12	18346	9483	8863	33
22-10960103-C-T	0.25	3	6	4	0	4	15
22-10960489-A-G	0.333333	4	4	41002	20759	20243	31
22-10962036-C-G	0.083333	1	2	0	0	0	12
22-10964790-A-G	0.5	6	12	1	0	1	19
22-10965914-G-C	0.5	6	12	11	2	9	15
22-11016875-A-C	0.333333	4	8	6	2	4	26
22-11016893-C-T	0.083333	1	12	0	0	0	10
22-11018553-C-T	0.25	3	12	81	42	39	19
22-11020576-C-CCA	0.166667	2	4	5572	2910	2662	10
22-11024713-A-C	0.166667	2	4	8858	5032	3826	28
22-11025747-C-CAAA	0.166667	2	2	8	5	3	12
22-11025933-T-C	0.416667	5	8	32114	16252	15862	37
22-11029255-T-C	0.25	3	4	31819	16054	15765	39
22-11030623-G-A	0.083333	1	2	0	0	0	11
22-11030676-G-A	0.333333	4	8	0	0	0	13
22-11031654-C-CCTGTCTCTCTCTCT	0.333333	4	4	23987	12240	11747	10
22-11031716-TCC-T	0.25	3	6	2	0	2	13
22-11031737-G-C	0.25	3	6	20	8	12	14
22-11031744-T-TCTC	0.083333	1	2	0	0	0	11
22-11031753-G-C	0.083333	1	4	23	9	14	16
22-11031755-C-G	0.083333	1	8	9	5	4	13
22-11031920-C-T	0.25	3	8	2	1	1	27
22-11031984-C-CCT	0.25	3	10	14	2	12	17
22-11032079-A-T	0.416667	5	8	1559	748	811	15
22-11032086-C-G	0.333333	4	5	20	10	10	28
22-11032106-CTG-C	0.333333	4	5	8	4	4	20
22-11032666-A-AT	0.083333	1	8	0	0	0	12
22-11032775-A-C	0.75	9	12	46549	23616	22933	53
22-11033002-G-A	0.25	3	6	0	0	0	10
22-11033126-GCT-G	0.333333	4	4	41333	20893	20440	14
22-11033496-GT-G	0.333333	4	4	18523	9390	9133	13
22-11034062-T-C	0.416667	5	8	31136	15631	15505	35
22-11034826-T-C	0.416667	5	6	9955	4960	4995	21
22-11035526-CA-C	0.166667	2	8	1	1	0	16
22-11035680-C-T	0.166667	2	8	0	0	0	10
22-11035898-T-TA	0.333333	4	5	5	3	2	18
22-11036651-T-C	0.25	3	4	29140	14672	14468	42
22-11036851-C-T	0.416667	5	10	0	0	0	11
22-11037359-T-A	0.416667	5	12	0	0	0	12
22-11038186-T-G	0.166667	2	2	24997	12535	12462	27
22-11038289-C-T	1	12	12	73766	37696	36070	45
22-11038614-A-G	0.166667	2	2	39849	20277	19572	41
22-11038886-T-G	0.5	6	12	1252	641	611	13
22-11039872-C-T	0.25	3	6	27482	13696	13786	33
22-11040644-A-C	0.166667	2	4	45118	22926	22192	15
22-11041683-A-G	0.166667	2	6	34117	17270	16847	17
22-11041907-A-G	1	12	12	67915	34508	33407	41
22-11042495-T-C	0.583333	7	8	12293	5965	6328	35
22-11043084-C-A	0.083333	1	6	0	0	0	10
22-11046524-A-G	0.166667	2	4	28065	14415	13650	13
22-11049820-T-A	0.166667	2	2	31354	15809	15545	26
22-11050102-G-A	0.083333	1	12	0	0	0	10
22-11050239-G-A	0.166667	2	6	1	1	0	10
22-11050622-T-C	0.333333	4	6	31818	16135	15683	36
22-11052874-C-T	0.166667	2	2	11810	6432	5378	16
22-11056723-CTTTAT-C	0.25	3	3	0	0	0	18
22-11057817-CAA-C	0.5	5	9	28	18	10	16
22-11057855-TA-T	0.5	4	8	63	27	36	17
22-11057860-A-T	0.083333	1	6	0	0	0	10
22-11057905-A-G	0.083333	1	10	825	390	435	13
22-11057926-C-G	0.416667	5	8	35448	17904	17544	40
22-11058068-A-G	0.25	3	4	39906	20238	19668	38
22-11058270-C-T	0.083333	1	8	4	2	2	12
22-11058327-T-G	0.166667	2	4	32256	16310	15946	33
22-11058827-T-TTTTG	0.416667	5	8	259	116	143	18
22-11059813-G-T	0.166667	2	4	32593	16461	16132	33
22-11061368-T-C	0.166667	3	4	26035	13326	12709	11
22-11065176-T-TC	0.333333	4	8	86	37	49	25
22-11066301-T-C	1	12	12	75908	38818	37090	49
22-11066965-C-G	0.083333	1	12	0	0	0	10
22-11068044-A-T	0.25	3	4	40635	20565	20070	48
22-11121322-T-C	0.166667	2	10	0	0	0	15
22-11128486-G-GT	0.166667	2	8	20	12	8	12
22-11128808-T-C	0.25	3	8	5797	3102	2695	26
22-11128828-T-C	0.5	6	10	21296	10979	10317	31
22-11131154-G-A	0.583333	7	8	69	35	34	15
22-11131189-G-A	0.666667	8	8	16761	8852	7909	26
22-11131194-C-T	0.083333	1	4	547	241	306	11
22-11131195-G-T	0.083333	1	4	517	229	288	11
22-11131294-C-T	0.5	6	8	20894	10792	10102	27
22-11132695-A-G	0.416667	5	6	10508	5594	4914	20
22-11132759-A-C	0.75	9	10	3939	2143	1796	25
22-11133782-G-C	0.666667	8	12	3273	1871	1402	31
22-11134035-A-G	0.666667	8	10	18236	9339	8897	25
22-11137754-G-A	0.5	5	10	7456	3952	3504	17
22-11138240-T-C	0.166667	2	4	67	34	33	14
22-11148400-A-C	0.166667	2	10	0	0	0	11
22-11149969-G-A	0.333333	4	6	7	2	5	14
22-11150852-A-G	0.5	6	10	1019	514	505	16
22-11152372-T-C	0.5	6	12	414	231	183	21
22-11152664-C-T	0.333333	4	8	681	339	342	16
22-11152807-C-CA	0.25	3	4	24	14	10	17
22-11152880-G-A	0.416667	5	10	5166	2911	2255	14
22-11158186-C-T	0.5	6	10	0	0	0	15
22-11158187-A-G	0.5	6	8	0	0	0	15
22-11158204-T-A	0.5	6	8	0	0	0	14
22-11158374-T-C	0.166667	2	8	0	0	0	14
22-11158380-C-T	0.166667	2	8	0	0	0	12
22-11158518-G-C	0.666667	8	10	0	0	0	23
22-11158523-A-G	0.166667	2	4	0	0	0	12
22-11159983-A-G	0.166667	2	4	2669	1507	1162	15
22-11160217-G-A	0.166667	2	4	854	447	407	12
22-11160562-CT-C	0.166667	2	8	0	0	0	11
22-11211183-C-A	0.166667	2	10	1883	941	942	38
22-11211392-C-A	0.416667	5	12	14031	7251	6780	52
22-11211558-CAAAGTACACGAAATACATATTATATACTGTACATAAAATACG-C	0.416667	5	12	12118	6347	5771	21
22-11211611-A-G	0.333333	4	12	1113	546	567	38
22-11211938-C-A	0.416667	5	12	13959	7219	6740	53
22-11211939-C-T	0.166667	2	12	919	474	445	48
22-11211973-T-TA	0.916667	11	12	54073	27805	26268	65
22-11212130-C-A	0.333333	4	12	626	316	310	50
22-11212240-A-G	0.333333	4	12	1189	587	602	53
22-11212656-T-C	0.083333	1	12	0	0	0	11
22-11213318-G-A	0.916667	11	12	53284	27322	25962	70
22-11213887-C-A	0.166667	2	12	6292	3121	3171	43
22-11213888-T-A	0.166667	2	12	6304	3130	3174	46
22-11214137-T-C	0.416667	5	12	13750	7141	6609	55
22-11214545-G-A	0.75	9	12	26392	13668	12724	59
22-11214865-G-T	0.25	3	12	3361	1804	1557	64
22-11214910-A-T	0.166667	2	12	1408	757	651	61
22-11215071-G-T	0.5	6	12	28248	14825	13423	65
22-11215176-C-A	0.25	3	12	0	0	0	63
22-11215181-T-A	1	12	12	60431	31486	28945	66
22-11215423-A-T	0.5	6	10	2864	1496	1368	27
22-11215445-G-C	0.583333	7	8	1	0	1	13
22-11215455-C-T	1	12	12	5873	3110	2763	29
22-11215460-A-G	0.75	9	12	0	0	0	18
22-11215463-A-T	0.166667	2	6	0	0	0	19
22-11217381-T-C	0.666667	8	10	3886	2232	1654	22
22-11217672-G-T	0.333333	4	12	613	308	305	23
22-11218305-C-T	0.916667	11	12	56629	28941	27688	66
22-11219306-A-T	0.916667	11	12	56454	28843	27611	67
22-11219527-A-T	0.333333	4	12	1123	561	562	54
22-11220228-TTTGA-T	0.333333	4	12	1141	565	576	57
22-11226567-C-T	0.666667	8	12	418	216	202	17
22-11236870-A-T	0.083333	1	12	8	2	6	11
22-11237819-A-T	0.5	6	10	83	50	33	14
22-11240399-G-T	0.25	3	12	837	442	395	11
22-11243117-T-C	0.166667	2	10	NA	NA	NA	15
22-11244964-C-T	0.416667	5	12	11867	6354	5513	17
22-11245758-G-C	0.333333	4	12	627	313	314	21
22-11248219-C-T	0.416667	5	10	2212	1167	1045	18
22-11251338-A-G	0.166667	2	12	4956	2663	2293	34
22-11252890-G-T	0.333333	4	12	1161	580	581	40
22-11252938-G-T	0.333333	4	12	1137	559	578	37
22-11253125-G-A	0.416667	5	12	14539	7459	7080	50
22-11253243-T-C	0.916667	11	12	57267	29182	28085	61
22-11253469-G-T	0.333333	4	12	1187	586	601	60
22-11253505-G-A	0.333333	4	12	1193	586	607	63
22-11253680-C-T	0.333333	4	12	659	329	330	18
22-11253913-C-T	0.25	3	10	127	68	59	15
22-11255407-G-A	0.333333	4	10	69	47	22	15
22-11257293-A-T	0.166667	2	12	31	14	17	22
22-11257413-G-C	0.25	3	8	4	2	2	11
22-11258563-C-T	0.333333	4	8	137	58	79	15
22-11261178-G-C	0.5	6	10	45	24	21	13
22-11261597-A-G	0.5	5	6	18277	9804	8473	22
22-11261655-C-T	0.666667	8	10	9394	5341	4053	10
22-11261689-G-A	0.166667	2	10	0	0	0	13
22-11261723-C-A	0.166667	2	8	0	0	0	13
22-11262578-A-C	0.166667	2	6	3	3	0	15
22-11266163-G-GAGA	0.5	5	6	179	85	94	12
22-11266817-A-G	0.833333	10	10	17479	9005	8474	50
22-11267907-TTTC-T	0.25	2	10	891	487	404	10
22-11268462-C-T	0.166667	2	12	15	5	10	13
22-11268629-T-A	1	12	12	17414	9379	8035	34
22-11270999-G-A	0.5	6	12	26	14	12	14
22-11275935-C-CTT	0.75	10	12	0	0	0	16
22-11276760-A-G	0.666667	8	8	0	0	0	32
22-11277080-G-A	0.166667	2	12	242	113	129	11
22-11282239-G-A	0.583333	7	10	6452	3331	3121	16
22-11282337-A-G	0.666667	6	10	13531	7073	6458	10
22-11282735-T-A	0.416667	5	6	4	2	2	10
22-11283340-T-C	0.833333	10	12	0	0	0	14
22-11284131-A-C	0.166667	2	8	0	0	0	12
22-11284316-A-G	0.5	6	8	51	18	33	12
22-11284518-A-G	0.333333	4	12	14	6	8	14
22-11284558-A-G	0.166667	2	12	0	0	0	12
22-11284615-T-C	0.916667	11	12	48976	25736	23240	40
22-11285026-C-G	0.916667	11	12	58292	29727	28565	46
22-11285076-G-A	0.083333	1	8	0	0	0	14
22-11285259-GT-G	0.5	6	12	189	86	103	45
22-11287257-T-C	0.083333	1	8	0	0	0	26
22-11287704-C-T	0.083333	1	6	0	0	0	12
22-11287766-C-A	0.166667	2	12	0	0	0	10
22-11287923-TA-T	0.416667	5	10	0	0	0	31
22-11288466-G-A	0.5	6	12	8	4	4	15
22-11288890-T-C	0.25	3	6	0	0	0	17
22-11289033-G-C	0.916667	11	12	52931	27010	25921	55
22-11289379-T-A	0.833333	10	12	26557	13669	12888	54
22-11289784-C-T	0.916667	11	12	43385	22028	21357	43
22-11290043-G-A	0.166667	2	12	13	4	9	24
22-11290091-A-G	0.333333	4	12	1	0	1	14
22-11290118-T-A	0.083333	1	6	1	0	1	14
22-11290561-C-T	0.25	3	6	2	1	1	20
22-11291036-TA-T	0.833333	10	12	818	410	408	46
22-11291555-A-C	0.25	3	6	5	1	4	40
22-11291723-G-T	0.166667	2	4	0	0	0	15
22-11291948-A-G	0.5	6	12	217	107	110	18
22-11292131-T-C	0.25	3	8	1	0	1	11
22-11293085-C-T	0.083333	1	2	3	1	2	23
22-11293150-A-T	0.25	3	6	2	1	1	23
22-11293352-T-G	0.333333	4	8	213	106	107	27
22-11293462-C-T	0.166667	2	6	1	0	1	10
22-11294076-TA-T	0.333333	4	8	3	1	2	28
22-11294670-G-T	0.083333	1	2	0	0	0	10
22-11295708-T-TTTG	0.25	3	12	0	0	0	11
22-11295866-A-G	0.833333	10	10	57808	29464	28344	42
22-11295907-A-G	0.833333	10	10	63418	32472	30946	45
22-11296595-T-C	0.833333	10	10	57840	29477	28363	44
22-11297466-T-C	0.916667	11	12	57859	29487	28372	60
22-11297968-T-C	0.333333	4	8	1	0	1	18
22-11298024-A-C	0.916667	11	12	57891	29506	28385	53
22-11298427-C-T	1	12	12	896	427	469	53
22-11300166-G-A	0.333333	4	10	4	1	3	13
22-11300315-C-A	0.5	6	12	2	0	2	39
22-11300440-C-CAAA	0.166667	2	6	2	1	1	13
22-11300495-C-T	0.416667	5	10	0	0	0	31
22-11300938-T-G	1	12	12	76123	38933	37190	45
22-11301692-CA-C	0.666667	8	12	14375	7167	7208	60
22-11302772-T-C	0.5	6	12	1	0	1	22
22-11302845-T-C	0.416667	5	10	1	0	1	14
22-11303341-A-G	0.916667	11	12	57824	29480	28344	56
22-11303560-C-T	0.5	6	12	0	0	0	17
22-11304110-T-C	0.916667	11	12	57855	29485	28370	51
22-11307217-G-A	0.5	6	12	2	1	1	21
22-11307379-T-C	0.5	6	12	224	108	116	25
22-11308463-T-G	0.5	6	12	226	107	119	17
22-11308606-G-A	0.5	6	12	216	104	112	20
22-11308814-C-T	0.333333	4	8	0	0	0	37
22-11309100-T-G	0.916667	11	12	57803	29463	28340	59
22-11309132-G-A	0.333333	4	10	0	0	0	18
22-11309791-C-T	0.5	6	12	4	3	1	10
22-11310057-G-A	0.5	6	12	11	5	6	11
22-11310758-G-C	0.5	6	12	0	0	0	23
22-11312610-C-T	0.916667	11	12	57660	29374	28286	51
22-11312959-C-T	0.166667	2	4	1	0	1	16
22-11313562-TTCTTTAAGCAG-T	0.333333	4	12	0	0	0	24
22-11314264-T-A	0.166667	2	8	0	0	0	15
22-11314972-C-CA	0.083333	1	4	25	10	15	22
22-11315661-T-G	0.75	9	10	26634	13708	12926	50
22-11317468-G-A	0.916667	11	12	57825	29469	28356	51
22-11317996-A-G	0.833333	10	10	0	0	0	24
22-11318540-C-CATCT	0.25	3	12	4	1	3	13
22-11318591-GTA-G	0.916667	11	12	55112	28064	27048	40
22-11319762-G-T	0.333333	4	10	1	0	1	10
22-11320062-C-T	0.25	3	12	31	14	17	19
22-11320566-G-A	0.583333	7	12	805	441	364	13
22-11320665-C-T	0.166667	2	8	16	9	7	12
22-11323734-A-C	0.166667	2	4	233	108	125	16
22-11323880-G-A	0.25	3	8	1	0	1	10
22-11324995-A-G	0.75	9	10	26528	13645	12883	43
22-11326517-AT-A	0.5	6	12	119	58	61	23
22-11326954-CTTA-C	0.25	4	12	1	0	1	14
22-11328207-T-C	0.25	3	6	0	0	0	15
22-11329278-G-C	0.75	9	10	26495	13628	12867	59
22-11330297-A-T	0.333333	4	10	0	0	0	11
22-11330555-C-T	0.25	3	10	0	0	0	11
22-11331471-T-C	0.416667	5	10	1	0	1	16
22-11332014-C-T	0.166667	2	12	0	0	0	10
22-11332154-T-A	0.333333	4	10	1	0	1	10
22-11332409-A-T	0.333333	4	8	218	101	117	25
22-11332840-A-C	1	12	12	73948	37883	36065	40
22-11333728-A-G	0.166667	2	4	415	213	202	10
22-11334291-G-T	0.166667	2	4	0	0	0	10
22-11334701-G-A	0.166667	2	8	0	0	0	13
22-11334791-C-A	0.416667	5	12	4	2	2	15
22-11334792-A-T	0.416667	5	12	4	2	2	18
22-11335533-G-A	0.916667	11	12	26392	13619	12773	47
22-11335929-G-T	1	12	12	47387	23909	23478	42
22-11336499-C-T	0.25	3	8	2	1	1	11
22-11336765-C-T	0.916667	11	12	57235	29158	28077	55
22-11336791-T-C	0.25	3	6	215	100	115	29
22-11337001-A-G	0.333333	4	8	250	116	134	10
22-11337022-A-AAGCCTGGGCAATGGCGGGGGCCCCTCCCCC	0.166667	2	6	72670	37331	35339	13
22-11337075-T-C	0.166667	2	4	242	113	129	15
22-11337094-T-G	0.083333	1	2	231	107	124	13
22-11338789-T-G	1	12	12	76118	38931	37187	40
22-11339181-A-T	0.916667	11	12	57559	29257	28302	52
22-11339646-T-G	0.416667	5	12	1	0	1	11
22-11340458-T-G	0.833333	10	10	57773	29397	28376	46
22-11341939-G-T	0.25	3	10	1	0	1	15
22-11342606-A-T	0.916667	11	12	1974	904	1070	36
22-11343007-C-T	0.583333	7	12	0	0	0	15
22-11343281-C-A	0.25	3	6	0	0	0	19
22-11343325-A-T	0.333333	4	8	0	0	0	14
22-11343816-C-T	0.5	6	12	0	0	0	17
22-11343829-G-A	0.333333	4	8	1	0	1	14
22-11344530-A-C	0.916667	11	12	58805	29957	28848	56
22-11344958-A-G	1	12	12	76148	38941	37207	57
22-11345470-A-G	0.916667	11	12	57926	29486	28440	49
22-11345572-A-G	0.916667	11	12	57834	29435	28399	49
22-11346957-G-T	0.916667	11	12	57659	29344	28315	50
22-11347361-G-T	0.416667	5	10	0	0	0	15
22-11347969-G-A	0.416667	5	10	0	0	0	14
22-11350110-CA-C	1	12	12	31843	16203	15640	42
22-11350867-T-C	0.75	9	10	27382	14056	13326	59
22-11352481-G-A	0.833333	10	10	57748	29386	28362	44
22-11353006-T-G	0.833333	10	10	43737	22304	21433	43
22-11353621-C-T	0.25	3	6	0	0	0	11
22-11353623-G-T	0.166667	2	4	0	0	0	14
22-11354086-T-A	0.416667	5	10	0	0	0	12
22-11354099-G-C	0.333333	4	10	0	0	0	13
22-11356363-AGT-A	0.25	3	12	1107	550	557	22
22-11356363-AGTGTGTGT-A	0.25	3	12	0	0	0	22
22-11356363-AGTGTGT-A	0.166667	2	12	11	4	7	22
22-11356407-C-T	0.5	5	10	65	28	37	19
22-11356675-A-T	0.916667	11	12	57757	29395	28362	58
22-11356705-G-T	0.083333	1	10	1	0	1	17
22-11358023-A-G	0.166667	2	8	0	0	0	10
22-11359162-G-C	0.083333	1	6	0	0	0	12
22-11360020-G-C	0.083333	1	2	1	1	0	13
22-11360386-A-T	0.333333	4	12	1	1	0	13
22-11360779-G-A	0.333333	4	8	0	0	0	18
22-11360942-G-A	0.5	6	12	1	1	0	32
22-11361083-T-C	0.333333	4	8	251	118	133	22
22-11361209-G-GTTC	0.166667	2	4	252	119	133	20
22-11361802-G-A	0.416667	5	10	0	0	0	20
22-11361933-C-T	0.333333	4	8	12	4	8	11
22-11362967-T-A	0.833333	10	10	57755	29396	28359	51
22-11363592-C-T	0.75	9	10	27199	13951	13248	46
22-11363812-T-C	0.75	9	10	27170	13939	13231	53
22-11365839-T-C	0.5	6	12	15	6	9	14
22-11366045-G-A	0.416667	5	10	20	9	11	13
22-11366102-T-G	0.25	3	6	0	0	0	15
22-11366511-G-A	0.333333	4	8	13	9	4	12
22-11367008-C-G	0.75	11	12	18101	9122	8979	30
22-11367068-AT-A	0.416667	5	12	1	0	1	16
22-11367071-T-A	0.25	3	8	2	0	2	10
22-11367077-C-T	0.416667	5	12	1	0	1	14
22-11367507-C-T	0.5	6	12	0	0	0	32
22-11367708-C-A	0.166667	2	4	0	0	0	24
22-11367777-T-G	0.25	3	6	253	115	138	15
22-11367852-T-A	0.166667	2	12	0	0	0	20
22-11368129-T-C	0.5	6	12	14	7	7	26
22-11368162-G-A	1	12	12	76052	38898	37154	51
22-11368297-T-A	0.5	6	12	14	6	8	29
22-11368704-T-C	0.5	6	12	13	6	7	23
22-11371620-T-C	0.333333	4	8	19	11	8	24
22-11371721-GT-G	0.5	6	12	0	0	0	21
22-11372411-G-A	0.25	3	8	2	1	1	16
22-11372501-A-G	0.916667	11	12	58629	29865	28764	54
22-11372577-A-G	0.5	6	12	248	116	132	24
22-11373020-C-A	0.333333	4	8	2	1	1	10
22-11373088-C-T	0.5	6	12	245	114	131	25
22-11373901-CA-C	0.5	6	11	531	275	256	22
22-11373901-C-CAAA	0.083333	1	11	2	0	2	22
22-11374537-G-C	0.833333	10	12	27198	13950	13248	62
22-11376773-C-T	0.166667	2	8	0	0	0	12
22-11430178-G-A	0.166667	2	12	0	0	0	15
22-11430289-T-C	0.833333	10	12	30983	16441	14542	58
22-11432201-T-G	0.833333	10	12	33919	17982	15937	58
22-11432484-T-C	0.833333	10	12	39811	20859	18952	50
22-11434714-G-A	0.166667	2	12	4083	2208	1875	61
22-11434776-C-A	0.333333	4	12	4937	2673	2264	47
22-11434810-C-A	0.25	3	8	32	12	20	18
22-11434821-C-T	0.25	3	6	42	14	28	20
22-11436063-A-G	0.166667	2	4	0	0	0	15
22-11436298-T-C	0.166667	2	12	0	0	0	10
22-11436682-A-T	0.166667	2	12	80	51	29	44
22-11438673-A-T	0.333333	4	12	8289	4283	4006	53
22-11438686-G-T	0.333333	4	12	8200	4249	3951	49
22-11438746-C-T	0.166667	2	12	1823	1020	803	45
22-11441800-A-G	0.333333	4	12	3364	1885	1479	56
22-11441826-CTA-C	0.416667	5	8	16132	8632	7500	45
22-11443552-C-T	0.166667	2	12	9	8	1	28
22-11444033-G-T	0.166667	2	4	58	23	35	16
22-11444398-CT-C	0.666667	6	7	4023	2140	1883	26
22-11446079-G-GT	0.333333	4	10	2544	1409	1135	52
22-11446341-G-A	0.333333	4	12	11496	5988	5508	74
22-11446692-T-A	0.333333	4	12	1966	1020	946	56
22-11446929-G-A	0.333333	4	12	6333	3264	3069	36
22-11447217-G-A	0.833333	10	12	11469	5902	5567	41
22-11448434-G-GT	0.833333	10	12	28690	15292	13398	48
22-11448829-AT-A	0.333333	4	12	4779	2614	2165	42
22-11449047-C-T	0.166667	2	12	3145	1702	1443	57
22-11449533-T-TTG	0.166667	2	10	0	0	0	10
22-11449772-G-A	0.25	3	12	862	449	413	47
22-11451024-G-GT	0.833333	10	10	28563	14728	13835	43
22-11451215-G-A	0.25	3	8	0	0	0	14
22-11451216-T-C	0.25	3	8	0	0	0	12
22-11451853-A-C	0.833333	10	12	35704	18819	16885	51
22-11451948-C-CT	0.166667	2	12	2701	1491	1210	28
22-11451962-C-G	0.166667	2	12	2822	1532	1290	45
22-11453264-C-A	0.333333	4	12	10625	5517	5108	57
22-11454555-G-A	0.166667	2	12	15	7	8	13
22-11454595-C-T	0.166667	2	12	6	2	4	19
22-11454636-C-T	0.166667	2	12	9	3	6	14
22-11454792-A-G	0.166667	2	10	0	0	0	10
22-11454802-G-A	0.166667	2	10	1	1	0	12
22-11454818-A-T	0.166667	2	12	4	2	2	10
22-11454836-A-C	0.166667	2	12	6	3	3	13
22-11454859-T-G	0.166667	2	12	6	3	3	17
22-11454866-A-G	0.166667	2	12	6	3	3	16
22-11455016-C-A	0.166667	2	4	239	130	109	20
22-11455019-G-T	0.166667	2	4	255	143	112	24
22-11455172-A-G	0.166667	2	10	452	246	206	20
22-11455203-A-C	0.166667	2	12	894	450	444	24
22-11455319-G-A	0.083333	1	8	5	3	2	15
22-11455321-T-C	0.166667	2	6	6299	3425	2874	21
22-11455322-G-A	0.166667	1	8	4	2	2	10
22-11455360-T-C	0.166667	2	10	3384	1884	1500	12
22-11455445-A-G	0.166667	2	10	7	5	2	20
22-11456495-T-A	0.166667	2	12	1	0	1	10
22-11456502-G-A	0.166667	2	10	NA	NA	NA	12
22-11456503-A-T	0.166667	2	12	NA	NA	NA	11
22-11456520-G-C	0.166667	2	10	1	0	1	13
22-11460645-T-A	0.166667	2	4	84	42	42	18
22-11460948-T-C	0.166667	2	4	68	28	40	17
22-11463104-T-C	0.333333	4	12	10545	5526	5019	44
22-11465076-G-A	0.166667	2	12	2975	1614	1361	31
22-11465949-T-C	0.166667	2	12	0	0	0	12
22-11466566-T-G	0.833333	10	12	39418	20679	18739	62
22-11466703-C-T	0.333333	4	12	2886	1555	1331	52
22-11466863-C-A	0.333333	4	12	5884	3192	2692	59
22-11467944-A-G	0.166667	2	12	94	61	33	43
22-11468008-T-C	0.166667	2	12	106	70	36	47
22-11469495-AAT-A	0.833333	10	12	28298	15111	13187	56
22-11472082-C-A	0.25	3	4	1	1	0	18
22-11472989-C-G	0.166667	2	12	3077	1680	1397	45
22-11474181-C-T	0.166667	2	12	1007	556	451	43
22-11475466-A-G	0.333333	4	12	637	353	284	44
22-11475929-C-CCA	0.166667	2	10	1788	997	791	37
22-11477280-G-C	0.166667	2	10	1211	672	539	28
22-11477284-T-G	0.166667	2	10	1370	760	610	29
22-11477291-G-GAA	0.166667	2	10	1635	902	733	17
22-11477292-G-A	0.166667	2	8	1724	953	771	34
22-11477360-G-A	0.166667	2	12	8560	4656	3904	21
22-11477380-T-C	0.166667	2	12	10517	5755	4762	11
22-11477429-A-G	0.166667	2	12	11537	6287	5250	17
22-11478767-G-A	0.833333	10	12	32205	17121	15084	46
22-11481008-C-T	0.166667	2	6	452	246	206	19
22-11481014-G-T	0.166667	2	10	0	0	0	15
22-11481072-A-C	0.333333	4	6	27	9	18	33
22-11481311-C-A	0.166667	2	12	2344	1277	1067	24
22-11481376-C-T	0.166667	2	12	18	11	7	10
22-11482117-A-G	0.166667	2	2	9	4	5	14
22-11482903-G-C	0.166667	2	12	287	171	116	31
22-11482904-T-C	0.166667	2	12	286	170	116	31
22-11482907-T-A	0.166667	2	12	284	171	113	30
22-11483251-C-G	0.166667	2	12	1	0	1	11
22-11483306-T-G	0.25	3	12	1536	845	691	24
22-11483460-A-G	0.166667	2	12	11	7	4	12
22-11484956-C-T	0.166667	2	12	1347	745	602	57
22-11486476-C-T	0.083333	1	12	233	132	101	21
22-11488372-T-C	0.833333	10	12	48894	25071	23823	60
22-11488808-A-C	0.833333	10	12	31767	16880	14887	48
22-11490125-C-T	0.166667	2	12	677	365	312	50
22-11491704-C-T	0.333333	4	8	3594	1954	1640	30
22-11493456-C-T	0.166667	2	12	209	122	87	19
22-11493457-G-T	0.166667	2	12	218	126	92	20
22-11493458-G-T	0.166667	2	10	225	130	95	23
22-11493555-C-T	0.166667	2	8	3201	1773	1428	10
22-11493606-A-G	0.166667	2	12	9183	5080	4103	13
22-11493635-G-A	0.166667	2	12	10146	5564	4582	13
22-11493638-G-A	0.166667	2	12	10233	5603	4630	18
22-11493714-T-G	0.166667	2	12	325	180	145	12
22-11493723-T-C	0.166667	2	12	376	208	168	29
22-11493729-A-G	0.166667	2	12	458	250	208	30
22-11493731-A-G	0.166667	2	12	468	255	213	33
22-11493745-T-G	0.166667	2	12	619	349	270	36
22-11493758-C-T	0.166667	2	6	817	460	357	34
22-11493761-T-C	0.166667	2	10	873	483	390	36
22-11493762-T-A	0.166667	2	8	882	488	394	35
22-11493773-G-C	0.166667	2	8	1052	579	473	33
22-11493789-CG-C	0.166667	2	12	1193	661	532	23
22-11493846-C-T	0.166667	2	10	4132	2278	1854	15
22-11493863-A-G	0.166667	2	8	2076	1126	950	13
22-11493875-G-C	0.166667	2	10	1280	690	590	18
22-11493877-A-G	0.166667	2	12	1077	578	499	19
22-11493995-C-T	0.166667	2	8	0	0	0	18
22-11493999-C-T	0.166667	2	10	0	0	0	17
22-11494028-G-T	0.166667	2	12	10	5	5	27
22-11494045-C-T	0.166667	2	10	21	8	13	18
22-11494091-G-T	0.166667	2	8	10	5	5	20
22-11494094-G-A	0.166667	2	8	8	4	4	17
22-11495656-C-T	0.333333	4	12	5632	3079	2553	33
22-11496003-T-C	0.25	3	12	1892	1054	838	20
22-11552100-G-A	0.5	5	8	18582	9652	8930	11
22-11552989-G-C	0.416667	5	10	18364	9525	8839	22
22-11553667-G-C	0.666667	8	12	53105	27460	25645	39
22-11553707-A-AAAT	0.25	2	7	255	143	112	24
22-11554186-T-C	0.5	6	8	54830	28382	26448	45
22-11560846-T-C	0.75	8	10	18207	9438	8769	12
22-11561762-A-G	0.166667	2	4	12	3	9	11
22-11562160-TATAG-T	0.666667	8	12	605	318	287	30
22-11562160-TATAGATAGATAG-T	0.166667	2	12	7	4	3	30
22-11563068-GT-G	0.083333	1	2	68	33	35	10
22-11564314-C-T	0.333333	4	10	1	0	1	19
22-11567740-T-C	0.5	6	12	0	0	0	19
22-11569249-C-T	0.083333	1	10	0	0	0	20
22-11569656-G-A	0.25	3	8	0	0	0	11
22-11572802-CT-C	0.083333	1	12	1	1	0	12
22-11573547-C-G	0.5	6	12	110	51	59	19
22-11573548-C-T	0.5	6	12	0	0	0	17
22-11573623-CA-C	0.416667	5	10	76	37	39	15
22-11576292-T-C	0.166667	2	10	0	0	0	18
22-11577310-G-A	0.5	6	12	0	0	0	15
22-11578345-C-A	0.5	6	12	14	4	10	26
22-11578677-T-C	0.5	6	12	0	0	0	20
22-11578776-T-C	0.166667	2	4	20	7	13	10
22-11578805-G-A	0.25	3	12	0	0	0	13
22-11579141-A-C	0.25	3	6	0	0	0	10
22-11580718-C-CT	0.416667	5	10	0	0	0	41
22-11580807-C-T	0.166667	2	12	0	0	0	24
22-11581061-TA-T	0.083333	1	12	0	0	0	12
22-11582525-G-A	0.333333	4	8	1	1	0	10
22-11582745-T-C	1	12	12	75870	38816	37054	53
22-11588152-C-CT	0.75	1	1	10482	5881	4601	16
22-11588709-C-CTTAAAT	0.25	3	6	12	3	9	14
22-11589221-C-T	0.416667	5	10	12	3	9	25
22-11589529-G-C	1	12	12	76155	38946	37209	50
22-11589775-A-G	1	12	12	75032	38421	36611	53
22-11590406-G-A	0.5	6	12	12	3	9	19
22-11591477-C-CT	0.166667	2	10	6	3	3	11
22-11592788-T-G	0.416667	5	10	1092	550	542	18
22-11593119-A-G	0.5	6	10	30846	15686	15160	55
22-11593927-AT-A	0.416667	5	10	24	9	15	12
22-11594172-T-C	0.166667	2	8	0	0	0	18
22-11594686-C-T	0.5	6	12	12	3	9	18
22-11595414-T-TA	0.333333	4	8	11	2	9	15
22-11595799-G-C	0.333333	4	8	12375	6512	5863	10
22-11596241-A-T	0.416667	5	10	0	0	0	12
22-11596278-T-C	0.083333	1	10	0	0	0	14
22-11597093-G-GT	0.083333	1	6	0	0	0	17
22-11598214-G-GA	0.416667	5	12	37	19	18	51
22-11598336-A-T	0.083333	1	12	0	0	0	11
22-11598366-C-T	0.25	3	6	13	4	9	23
22-11598610-TTGTGTGTCTG-T	0.166667	2	12	0	0	0	21
22-11598665-G-A	0.25	3	10	0	0	0	11
22-11598790-G-A	0.166667	2	12	1	0	1	14
22-11598809-G-A	0.166667	2	8	0	0	0	15
22-11599101-A-T	0.5	6	12	701	326	375	28
22-11599398-GC-G	0.416667	5	10	245	126	119	35
22-11599445-C-T	0.5	6	12	13	3	10	41
22-11599495-T-C	1	12	12	74686	38220	36466	52
22-11599689-A-G	0.083333	1	2	9918	5242	4676	15
22-11599773-A-G	0.416667	5	8	34538	17625	16913	42
22-11599916-A-C	0.416667	5	10	17	6	11	29
22-11600181-T-C	0.666667	8	12	40937	20730	20207	61
22-11600409-C-T	0.333333	4	10	44	19	25	29
22-11600515-G-C	0.25	3	10	0	0	0	11
22-11600821-C-G	0.416667	5	10	17	5	12	10
22-11601002-C-G	0.5	6	12	201	91	110	23
22-11601082-G-A	0.083333	1	12	0	0	0	25
22-11601348-T-C	0.666667	8	12	40924	20728	20196	51
22-11601369-C-T	0.25	3	4	200	93	107	11
22-11601676-G-A	0.083333	1	2	2	0	2	31
22-11604116-A-G	0.333333	4	8	602	271	331	14
22-11605396-A-G	0.166667	2	12	0	0	0	15
22-11605485-C-T	0.25	3	8	0	0	0	12
22-11605782-G-T	0.083333	1	10	1	0	1	26
22-11606104-G-A	0.083333	1	12	0	0	0	19
22-11606270-A-G	0.25	3	6	8033	4231	3802	14
22-11606379-T-C	0.333333	4	8	13188	6796	6392	20
22-11607073-A-T	0.583333	7	10	40671	20595	20076	52
22-11609816-G-A	0.5	6	6	7875	4008	3867	11
22-11610552-T-TGTG	0.333333	4	12	0	0	0	18
22-11611057-A-T	0.333333	4	8	18630	9646	8984	19
22-11611985-T-G	0.5	6	12	15	4	11	12
22-11611994-T-C	0.416667	5	10	14	3	11	19
22-11612385-TCTCTCACACACA-T	0.083333	1	4	2	0	2	21
22-11612389-T-TCACACA	0.25	2	4	8	5	3	21
22-11612389-TCA-T	0.166667	1	4	0	0	0	21
22-11612880-T-C	0.666667	8	12	40691	20611	20080	59
22-11613010-C-CCCATT	0.166667	2	12	1	0	1	22
22-11613343-A-C	0.416667	5	10	18456	9562	8894	12
22-11613350-A-G	0.166667	2	4	13	3	10	16
22-11613743-T-G	0.083333	1	2	17500	9059	8441	11
22-11613870-T-C	0.5	6	12	17000	8788	8212	29
22-11613894-CTCTTTCTT-C	0.166667	2	12	0	0	0	27
22-11613917-CTTTCTTCTTTCTTTCT-C	0.25	3	12	0	0	0	18
22-11614005-T-C	0.333333	4	8	11	2	9	23
22-11614186-G-T	0.083333	1	10	0	0	0	26
22-11614470-C-T	0.083333	1	12	0	0	0	10
22-11614617-C-A	0.666667	8	12	40394	20446	19948	45
22-11614783-G-GAGAGGGAA	0.5	6	12	410	168	242	20
22-11614899-CT-C	0.166667	2	6	0	0	0	25
22-11614946-G-A	0.083333	1	2	4	1	3	30
22-11615025-C-G	0.166667	2	4	14	4	10	14
22-11615190-A-G	0.5	6	12	629	276	353	39
22-11615357-C-CAAAT	0.5	6	12	112	61	51	24
22-11615458-T-C	0.416667	5	10	13	3	10	19
22-11615752-T-A	0.166667	2	4	16	6	10	19
22-11615763-TGAAA-T	0.333333	4	10	22	11	11	17
22-11615763-T-TGAAA	0.166667	2	10	468	225	243	17
22-11615929-G-T	0.5	6	12	12	2	10	42
22-11616090-GTC-G	0.333333	4	12	0	0	0	10
22-11616492-G-GTC	0.333333	4	8	10	4	6	44
22-11616564-CTCTG-C	0.083333	1	10	3	0	3	45
22-11616604-CT-C	0.416667	5	12	131	59	72	41
22-11616640-A-G	0.5	6	12	450	181	269	39
22-11616642-G-C	0.5	6	12	15	5	10	32
22-11616791-G-A	0.083333	1	12	0	0	0	25
22-11616836-A-G	0.416667	5	12	0	0	0	27
22-11616843-G-A	0.416667	5	12	0	0	0	20
22-11616929-TTC-T	0.416667	5	10	4	0	4	44
22-11617196-A-G	0.5	6	12	7171	3769	3402	37
22-11617375-A-G	0.5	6	12	17888	9263	8625	32
22-11617826-A-G	0.5	6	12	410	162	248	29
22-11618309-G-C	0.083333	1	10	0	0	0	14
22-11618644-G-C	0.5	6	12	8	1	7	21
22-11619513-T-C	0.25	3	12	0	0	0	20
22-11619605-C-G	0.083333	1	12	0	0	0	24
22-11619753-G-GTCTC	0.5	6	12	14	4	10	43
22-11619792-T-A	0.5	6	12	7	0	7	41
22-11620268-TTGTCTC-T	0.416667	5	12	0	0	0	35
22-11620757-T-C	0.5	6	12	413	163	250	16
22-11620903-C-T	0.416667	5	10	11	2	9	11
22-11621099-G-C	0.166667	2	12	4	0	4	21
22-11621235-T-C	0.333333	4	8	19657	10230	9427	13
22-11621261-C-T	0.083333	1	2	12	3	9	12
22-11621577-G-GGGGGT	0.5	6	12	6310	3425	2885	33
22-11622003-G-GTGTTTGACAC	0.333333	4	8	7703	4055	3648	11
22-11622802-A-ATTTAT	0.166667	2	9	31	19	12	14
22-11625783-A-AC	0.083333	1	12	0	0	0	15
22-11626159-C-T	0.5	6	12	13	3	10	21
22-11626445-A-G	0.083333	1	2	12	3	9	10
22-11626472-T-C	0.333333	4	8	18720	9710	9010	19
22-11626593-AGGCAGGCAGGCAGGCT-A	0.25	3	12	0	0	0	35
22-11626706-T-TG	0.25	3	10	32	14	18	38
22-11626708-G-T	0.083333	1	12	0	0	0	21
22-11626830-A-G	0.916667	11	12	68132	34942	33190	65
22-11626883-C-T	0.083333	1	12	0	0	0	43
22-11627051-T-A	0.5	6	12	11	2	9	22
22-11627317-G-A	0.5	6	12	11	2	9	12
22-11627594-C-T	0.5	6	12	51	14	37	21
22-11627741-A-G	0.583333	7	12	31930	16273	15657	59
22-11627862-G-C	0.333333	4	8	11	2	9	26
22-11627912-A-G	0.416667	5	10	7755	4076	3679	38
22-11628038-C-T	0.083333	1	12	0	0	0	15
22-11628419-T-G	0.666667	8	12	40708	20618	20090	56
22-11628460-C-T	0.083333	1	10	0	0	0	10
22-11628665-T-C	0.416667	5	10	19580	10177	9403	31
22-11628685-A-C	0.166667	2	12	0	0	0	10
22-11628948-A-G	0.333333	4	8	7631	4028	3603	14
22-11629528-T-C	0.333333	4	8	13	4	9	11
22-11629732-G-T	0.166667	2	12	0	0	0	13
22-11630223-C-T	0.083333	1	4	0	0	0	25
22-11630332-A-G	0.5	6	12	12	3	9	16
22-11630597-T-C	0.416667	5	10	12	3	9	25
22-11630815-AC-A	0.25	3	6	2	0	2	20
22-11682233-A-C	0.166667	2	2	7163	3980	3183	21
22-11682403-T-C	0.25	3	4	26005	13152	12853	33
22-11682515-C-G	0.416667	5	8	18192	9000	9192	37
22-11682861-A-G	0.416667	5	10	28059	14135	13924	37
22-11687881-A-C	0.5	6	6	98	42	56	16
22-11687927-C-T	0.166667	2	2	366	199	167	11
22-11687957-C-G	0.166667	2	2	83	46	37	16
22-11687960-C-G	0.166667	2	2	71	40	31	12
22-11687963-T-A	0.166667	2	2	76	40	36	13
22-11688091-T-C	1	12	12	373	179	194	11
22-11689044-G-T	0.25	3	8	754	369	385	11
22-11693335-A-T	0.5	6	12	1766	918	848	12
22-11694523-T-C	0.166667	2	12	0	0	0	15
22-11695441-T-G	0.25	3	8	573	282	291	22
22-11695630-G-C	0.5	6	12	12	4	8	18
22-11696102-C-G	0.333333	3	10	200	99	101	12
22-11697723-A-G	0.166667	2	6	6495	3412	3083	27
22-11698297-T-C	0.416667	5	8	19174	10043	9131	44
22-11698617-A-G	0.166667	2	2	26687	13469	13218	23
22-11698656-C-G	0.083333	1	6	0	0	0	17
22-11699693-T-C	0.416667	5	8	28235	14234	14001	27
22-11700344-T-A	0.166667	2	8	3830	2109	1721	12
22-11701904-C-T	0.416667	5	10	11470	5660	5810	29
22-11702998-T-C	0.166667	2	8	12	3	9	13
22-11704051-T-C	0.333333	4	8	247	116	131	14
22-11704100-GT-G	0.25	3	8	2751	1476	1275	11
22-11705134-T-G	0.333333	4	10	21059	10885	10174	23
22-11705335-C-CATAT	0.416667	5	10	3390	2088	1302	18
22-11705335-C-CGTAT	0.083333	1	10	3804	2160	1644	18
22-11705430-A-T	0.333333	2	4	334	195	139	15
22-11705641-G-GT	0.416667	5	10	5608	3038	2570	26
22-11706260-C-T	0.5	6	12	25	13	12	14
22-11706392-G-A	0.5	6	12	1767	826	941	21
22-11707415-A-G	0.166667	2	10	1266	660	606	12
22-11710728-C-G	0.166667	2	10	12979	7035	5944	25
22-11712655-A-G	0.166667	2	4	1380	711	669	12
22-11712790-A-G	0.166667	2	4	12978	6706	6272	19
22-11713453-C-T	0.416667	5	8	365	189	176	10
22-11713969-T-A	0.25	3	12	39	18	21	22
22-11714658-C-A	0.166667	2	4	5594	2876	2718	20
22-11715938-T-A	0.166667	2	4	4	2	2	11
22-11717846-C-CA	0.166667	2	10	555	314	241	28
22-11717863-G-A	0.5	6	12	24073	12136	11937	37
22-11721604-G-T	0.166667	2	8	0	0	0	19
22-11722751-T-C	0.166667	2	4	0	0	0	15
22-11723062-G-A	0.166667	1	12	2	0	2	10
22-11724067-C-A	0.333333	4	12	116	67	49	30
22-11775468-C-A	0.333333	4	12	517	261	256	17
22-11775625-T-C	0.5	6	12	5726	3086	2640	28
22-11776630-T-G	0.25	3	8	4459	2479	1980	13
22-11777043-G-A	0.166667	2	12	3	2	1	43
22-11779498-T-C	0.166667	2	4	1986	959	1027	17
22-11779989-T-TA	0.166667	2	6	0	0	0	10
22-11780599-G-A	0.333333	4	4	14	5	9	10
22-11780631-C-T	0.166667	2	2	70	36	34	14
22-11780693-G-T	0.166667	2	2	37	16	21	13
22-11780754-C-T	0.166667	2	8	1161	623	538	14
22-11780906-G-C	0.166667	2	4	180	87	93	17
22-11782547-G-A	0.5	6	12	15539	8250	7289	23
22-11782657-T-A	0.416667	5	10	14835	7907	6928	13
22-11782680-C-T	0.333333	4	8	14680	7854	6826	11
22-11783211-G-C	0.25	3	6	16469	8768	7701	22
22-11785560-T-C	0.166667	2	12	290	165	125	11
22-11785720-C-G	0.166667	2	4	48	21	27	33
22-11785721-A-G	0.083333	1	12	3	1	2	10
22-11785816-GC-G	0.166667	2	12	319	191	128	12
22-11785936-A-G	0.166667	2	4	3993	2171	1822	28
22-11786299-G-T	0.166667	2	8	40	18	22	14
22-11786350-G-A	0.166667	2	12	3	1	2	16
22-11786365-C-T	0.166667	2	10	43	19	24	28
22-11786500-T-C	0.166667	2	12	0	0	0	12
22-11786977-T-G	0.333333	4	12	966	565	401	34
22-11787271-T-C	0.166667	2	12	1192	665	527	51
22-11787480-G-A	0.333333	4	12	76	40	36	66
22-11788529-A-G	0.166667	2	12	0	0	0	21
22-11788556-G-A	0.166667	2	12	1	0	1	21
22-11788971-T-C	0.166667	2	12	1019	524	495	14
22-11789939-A-C	0.166667	2	8	25	13	12	17
22-11790945-T-C	0.166667	2	12	4631	2445	2186	13
22-11791290-T-G	0.166667	2	10	135	79	56	17
22-11791497-T-G	0.166667	2	8	58	28	30	25
22-11791698-G-T	0.083333	1	10	2	0	2	16
22-11791765-T-C	0.166667	2	8	2753	1418	1335	26
22-11791834-C-T	0.166667	2	12	9002	4780	4222	16
22-11791867-C-G	0.083333	1	8	246	128	118	14
22-11791888-T-C	0.166667	2	4	13322	7064	6258	20
22-11792008-C-G	0.166667	2	10	475	223	252	14
22-11792107-A-G	0.166667	2	10	22	10	12	14
22-11792184-A-T	0.166667	2	8	3369	1839	1530	10
22-11792348-AT-A	0.416667	6	9	11872	6470	5402	28
22-11792695-G-A	0.333333	4	8	296	144	152	22
22-11793896-A-C	0.166667	2	4	4851	2569	2282	21
22-11794700-A-C	0.166667	2	6	82	49	33	11
22-11794856-G-C	0.166667	2	8	0	0	0	15
22-11794954-G-A	0.166667	2	10	0	0	0	18
22-11795130-C-CCA	0.083333	1	10	2943	1616	1327	17
22-11795453-ATT-A	0.333333	4	10	32737	16848	15889	24
22-11795455-T-A	0.25	3	10	344	161	183	24
22-11795457-ATATT-A	0.333333	4	12	24018	12344	11674	19
22-11795782-T-G	0.166667	2	6	4	2	2	14
22-11797371-A-G	0.166667	2	8	1257	639	618	12
22-11797456-A-G	0.833333	10	12	53027	27301	25726	43
22-11798690-C-G	0.25	3	12	2326	1217	1109	51
22-11799178-C-T	0.25	3	6	479	288	191	12
22-11799195-C-G	0.166667	2	10	0	0	0	12
22-11799244-T-C	0.166667	2	10	0	0	0	18
22-11799393-T-C	0.083333	1	10	6	6	0	14
22-11799425-A-C	0.166667	2	8	704	374	330	24
22-11799426-G-C	0.166667	1	8	689	367	322	14
22-11799517-A-T	0.25	3	10	10215	5537	4678	20
22-11799678-C-A	0.166667	2	8	6280	3454	2826	12
22-11799690-G-A	0.166667	2	8	9	3	6	16
22-11799706-T-G	0.166667	2	12	23	8	15	15
22-11799736-T-A	0.083333	1	10	0	0	0	12
22-11799775-T-C	0.166667	2	10	7	2	5	23
22-11799809-G-T	0.166667	2	8	1872	984	888	32
22-11799840-T-C	0.25	3	6	4052	2267	1785	19
22-11799941-G-A	0.25	3	4	1476	787	689	17
22-11800073-C-CA	0.083333	1	10	81	41	40	10
22-11800116-T-C	0.166667	2	12	0	0	0	20
22-11800936-G-T	0.166667	2	4	0	0	0	27
22-11800953-C-G	0.166667	2	4	4	3	1	13
22-11801055-T-C	0.166667	2	8	3385	1797	1588	24
22-11801108-A-C	0.166667	2	8	10204	5445	4759	22
22-11801125-T-A	0.166667	2	4	12561	6692	5869	24
22-11801203-C-G	0.166667	2	8	15801	8414	7387	22
22-11801272-A-G	0.25	3	8	13709	7384	6325	40
22-11801429-G-A	0.166667	2	12	0	0	0	14
22-11801760-G-C	0.166667	2	10	5005	2603	2402	10
22-11802123-T-C	0.833333	10	12	43792	22941	20851	52
22-11803254-A-T	0.166667	2	6	137	66	71	18
22-11803481-A-G	0.333333	4	12	0	0	0	18
22-11803511-T-A	0.166667	2	2	5750	3193	2557	30
22-11804444-T-C	0.166667	2	4	1	0	1	12
22-11804586-T-C	0.166667	2	2	43	12	31	20
22-11804898-A-G	0.166667	2	2	298	155	143	11
22-11804948-C-A	0.166667	2	10	8	6	2	16
22-11805006-C-T	0.25	3	12	80	42	38	46
22-11805228-C-G	0.333333	4	12	784	443	341	32
22-11805495-T-C	0.166667	2	10	289	164	125	13
22-11806072-C-G	0.166667	2	4	569	324	245	13
22-11806073-A-C	0.166667	2	4	574	331	243	17
22-11806142-T-A	0.5	6	8	1094	611	483	22
22-11806190-A-G	0.5	6	10	266	132	134	24
22-11806639-T-G	0.166667	2	4	18	9	9	18
22-11806664-G-A	0.166667	2	6	142	68	74	13
22-11806763-G-C	0.166667	2	6	43	20	23	16
22-11806967-A-G	0.25	3	4	1	0	1	14
22-11807759-T-C	0.166667	2	6	0	0	0	14
22-11807838-A-G	0.166667	2	8	108	51	57	13
22-11808142-G-A	0.166667	2	12	7401	3954	3447	10
22-11808274-C-T	0.25	3	4	2070	1131	939	32
22-11808408-G-A	0.166667	2	6	897	460	437	15
22-11808568-A-G	0.25	3	6	8	5	3	18
22-11808683-G-T	0.166667	2	10	0	0	0	19
22-11808776-A-G	0.166667	2	10	115	58	57	13
22-11808778-G-A	0.166667	2	8	0	0	0	16
22-11808780-C-A	0.166667	2	6	0	0	0	11
22-11808841-A-G	0.166667	2	4	76	38	38	17
22-11808983-G-A	0.166667	2	4	177	101	76	12
22-11809414-G-A	0.166667	2	12	1656	923	733	41
22-11809765-G-A	0.25	3	4	465	276	189	11
22-11810413-G-A	0.166667	2	4	153	88	65	13
22-11810627-T-C	0.083333	1	12	1	1	0	17
22-11810640-G-A	0.166667	2	8	1340	756	584	24
22-11810735-C-T	0.25	3	4	8480	4698	3782	24
22-11810786-C-A	0.166667	2	4	642	338	304	10
22-11810890-A-G	0.166667	2	2	13818	7465	6353	27
22-11810922-C-T	0.166667	2	4	7094	3884	3210	23
22-11810935-G-A	0.166667	2	6	3919	2117	1802	23
22-11811425-T-A	0.333333	4	12	286	147	139	37
22-11811546-T-C	0.333333	4	6	6607	3724	2883	25
22-11811558-GT-G	0.5	4	8	2396	1223	1173	19
22-11811617-GAC-G	0.166667	2	4	573	310	263	15
22-11811621-T-TGG	0.166667	2	4	538	291	247	13
22-11811798-G-C	0.166667	2	6	828	457	371	21
22-11811811-G-A	0.166667	2	10	168	94	74	12
22-11811852-G-C	0.166667	2	12	446	250	196	25
22-11811867-A-G	0.166667	2	12	137	69	68	26
22-11811871-C-T	0.166667	2	8	2209	1205	1004	24
22-11813269-C-T	0.25	3	12	315	171	144	32
22-11814553-G-A	0.083333	1	12	17	9	8	10
22-11815033-G-C	0.166667	2	4	9734	5015	4719	12
22-11815164-G-T	0.166667	2	10	12	3	9	12
22-11815589-T-G	0.166667	2	8	524	220	304	18
22-11815743-C-A	0.166667	2	10	4083	2095	1988	17
22-11815880-T-G	0.166667	2	12	89	37	52	17
22-11817611-T-C	0.166667	2	10	4378	2258	2120	12
22-11818381-G-T	0.333333	4	12	2871	1524	1347	58
22-11818775-G-A	0.166667	2	8	42	24	18	14
22-11818811-T-A	0.166667	2	8	32	18	14	17
22-11818949-G-T	0.333333	4	10	4	1	3	55
22-11818961-C-A	0.166667	2	8	12	8	4	16
22-11818992-A-T	0.166667	2	8	118	57	61	13
22-11818993-G-T	0.166667	2	8	37	21	16	15
22-11818995-G-T	0.166667	2	8	38	21	17	15
22-11819028-C-G	0.166667	2	12	3317	1832	1485	37
22-11819453-C-G	0.666667	8	12	42929	21925	21004	61
22-11819959-T-C	0.333333	4	12	4	1	3	42
22-11821372-C-A	0.166667	2	12	0	0	0	12
22-11822481-A-G	0.166667	2	12	26	9	17	13
22-11822678-C-T	0.166667	2	12	0	0	0	12
22-11822745-TG-T	0.166667	2	12	24	7	17	46
22-11822746-GT-G	0.333333	4	12	2231	1178	1053	46
22-11822754-T-C	0.166667	2	12	14	3	11	12
22-11822766-C-G	0.166667	2	12	21	7	14	13
22-11822770-C-T	0.166667	2	12	21	7	14	11
22-11823044-T-C	0.166667	2	8	2487	1409	1078	19
22-11823050-C-A	0.166667	2	10	400	202	198	13
22-11823083-C-G	0.166667	2	10	3235	1767	1468	16
22-11823259-T-G	0.166667	2	10	6587	3520	3067	23
22-11823332-G-A	0.166667	2	12	305	166	139	24
22-11823377-G-GTT	0.166667	2	6	9	7	2	10
22-11823378-G-T	0.083333	1	7	4	3	1	11
22-11823431-C-A	0.166667	2	6	949	505	444	16
22-11823446-C-T	0.166667	2	2	1817	1048	769	17
22-11823909-C-T	0.166667	2	8	0	0	0	11
22-11824014-T-C	0.25	3	6	605	358	247	31
22-11824277-C-T	0.166667	2	6	6	2	4	10
22-11824321-C-T	0.166667	2	6	9	4	5	11
22-11824456-G-A	0.083333	1	8	5	4	1	13
22-11824468-C-CT	0.166667	2	4	61	37	24	22
22-11824702-A-G	0.083333	1	6	32	13	19	13
22-11824734-T-A	0.166667	2	8	3	2	1	13
22-11824858-CT-C	0.083333	1	12	368	197	171	10
22-11824881-C-G	0.166667	2	10	3	2	1	10
22-11824943-T-G	0.166667	2	12	254	138	116	11
22-11825181-G-T	0.083333	1	12	0	0	0	17
22-11825978-T-G	0.166667	2	6	2240	1237	1003	11
22-11826124-T-C	0.166667	2	6	10725	5887	4838	20
22-11826183-A-T	0.166667	2	6	5	2	3	17
22-11827198-T-G	0.166667	2	6	0	0	0	16
22-11827200-T-A	0.166667	2	8	0	0	0	18
22-11827407-C-G	0.166667	2	6	1	1	0	11
22-11829203-G-C	0.166667	2	10	0	0	0	13
22-11829272-T-G	0.333333	4	6	2841	1754	1087	11
22-11829304-G-C	0.25	3	6	262	137	125	25
22-11829338-G-C	0.166667	2	12	4303	2360	1943	15
22-11829351-T-C	0.166667	2	12	12814	6958	5856	11
22-11829409-C-G	0.166667	2	12	16559	8771	7788	39
22-11829424-T-C	0.166667	2	12	16973	8959	8014	16
22-11829506-T-C	0.166667	2	8	19289	10130	9159	25
22-11829827-T-G	0.166667	2	2	19710	10251	9459	12
22-11829887-G-A	0.166667	2	6	1943	978	965	15
22-11829928-A-C	0.166667	2	4	16939	8877	8062	26
22-11829961-T-C	0.166667	2	8	17088	8971	8117	22
22-11830033-T-TGC	0.166667	2	4	911	491	420	27
22-11830035-T-C	0.166667	2	6	1020	545	475	23
22-11830044-C-G	0.166667	2	6	966	519	447	24
22-11830054-C-T	0.166667	2	4	979	521	458	18
22-11830681-C-T	0.166667	2	12	0	0	0	12
22-11830863-T-G	0.166667	2	6	181	84	97	15
22-11830898-C-T	0.166667	2	6	3856	2164	1692	20
22-11831091-T-A	0.166667	2	10	499	257	242	22
22-11831413-C-T	0.166667	2	4	3337	1813	1524	23
22-11832161-A-T	0.333333	4	12	3	3	0	25
22-11832429-T-C	0.166667	2	10	0	0	0	13
22-11832885-A-G	0.166667	2	12	22083	11460	10623	17
22-11833696-C-T	0.166667	2	10	5	1	4	19
22-11833734-A-C	0.166667	2	4	0	0	0	13
22-11833803-TA-T	0.333333	3	4	4252	2293	1959	16
22-11833960-T-C	0.166667	2	10	637	367	270	15
22-11834086-C-T	0.166667	2	8	5008	2860	2148	23
22-11834262-G-A	0.166667	2	10	15427	8274	7153	15
22-11834394-C-T	0.166667	2	12	17650	9311	8339	18
22-11834719-C-T	0.166667	2	8	4	3	1	18
22-11834964-C-T	0.166667	2	4	2483	1446	1037	12
22-11836548-G-A	0.166667	2	12	1878	1027	851	23
22-11837596-G-T	0.166667	2	10	0	0	0	12
22-11838260-A-G	0.166667	2	8	688	379	309	22
22-11838656-C-A	0.166667	2	2	11062	5893	5169	12
22-11838810-G-T	0.166667	2	4	15687	8441	7246	32
22-11838852-G-GT	0.083333	1	3	766	452	314	11
22-11838932-T-C	0.166667	2	6	2434	1284	1150	15
22-11838955-C-T	0.166667	2	2	11163	6023	5140	23
22-11839269-T-C	0.166667	2	10	12808	6887	5921	21
22-11839340-C-T	0.166667	2	2	3026	1653	1373	17
22-11840807-A-G	0.166667	2	4	88	51	37	16
22-11840848-A-G	0.166667	2	8	3395	1888	1507	24
22-11840866-T-C	0.166667	2	8	3508	1935	1573	13
22-11841656-G-A	0.166667	2	8	9	5	4	15
22-11841688-T-C	0.166667	2	4	41	23	18	20
22-11841689-G-T	0.166667	2	4	47	27	20	21
22-11841987-C-T	0.166667	2	10	31	18	13	13
22-11842162-T-C	0.833333	10	12	20778	11083	9695	34
22-11843499-A-C	0.166667	2	2	1337	748	589	17
22-11844035-C-A	0.166667	2	8	1	0	1	12
22-11844130-G-T	0.5	6	10	10601	5792	4809	47
22-11844158-G-A	0.416667	5	8	10959	5980	4979	43
22-11844232-T-C	0.166667	2	8	211	116	95	28
22-11844233-C-T	0.166667	2	4	178	96	82	20
22-11844273-T-C	0.166667	2	2	71	32	39	16
22-11844385-C-CA	0.333333	4	6	10663	5729	4934	23
22-11844647-A-G	0.5	6	8	1363	801	562	30
22-11846747-T-A	0.25	3	8	1004	519	485	11
22-11846871-T-G	0.166667	2	6	0	0	0	11
22-11847174-T-A	0.166667	2	12	1207	664	543	24
22-11848049-T-A	0.833333	10	12	40782	21277	19505	45
22-11849644-G-A	0.333333	4	12	781	443	338	31
22-11851625-A-G	0.25	3	12	16	9	7	26
22-11853547-G-A	0.25	3	12	1402	761	641	16
22-11854477-G-A	0.166667	2	8	14	5	9	18
22-11856123-A-G	0.25	3	4	55	23	32	19
22-11857809-C-T	0.333333	4	6	65	35	30	12
22-11857976-A-G	0.333333	3	6	6978	3687	3291	12
22-11858125-G-T	0.166667	2	2	2	2	0	18
22-11858128-G-T	0.166667	2	4	1	0	1	20
22-11858209-G-A	0.416667	5	8	6	3	3	17
22-11858579-CT-C	0.5	6	10	0	0	0	25
22-11858646-C-T	0.166667	2	6	13	5	8	17
22-11858696-A-G	0.25	3	6	0	0	0	18
22-11858740-C-A	0.166667	1	4	2	0	2	15
22-11858810-G-A	0.25	3	12	390	207	183	21
22-11858818-A-C	0.25	3	8	14	6	8	27
22-11859133-A-G	0.166667	2	4	731	384	347	15
22-11859531-C-A	0.166667	2	2	134	53	81	16
22-11860045-T-C	0.666667	8	12	16094	8385	7709	36
22-11861639-G-C	0.166667	2	12	1197	673	524	28
22-11863369-C-T	0.333333	4	12	1866	998	868	34
22-11865093-G-C	0.166667	2	12	444	251	193	24
22-11866083-T-G	0.166667	2	6	3	3	0	12
22-11866186-C-T	0.166667	2	8	9	5	4	17
22-11866376-C-T	0.25	2	12	828	446	382	17
22-11866756-C-T	0.166667	2	6	2141	1176	965	17
22-11866759-T-A	0.166667	2	6	12567	6718	5849	28
22-11867019-T-A	0.166667	2	2	3722	1940	1782	22
22-11869003-A-T	0.333333	4	12	3051	1599	1452	48
22-11870204-A-C	0.166667	2	12	2306	1267	1039	60
22-11870962-T-TA	0.666667	8	12	6414	3551	2863	55
22-11872628-A-G	0.666667	8	12	3185	1721	1464	16
22-11872719-C-T	0.416667	5	10	886	473	413	13
22-11874671-A-G	0.166667	2	6	12	5	7	23
22-11874918-C-T	0.166667	2	8	2156	1158	998	18
22-11875093-A-C	0.333333	4	12	240	136	104	23
22-11875344-T-A	0.166667	2	6	9530	5234	4296	13
22-11878206-C-A	0.166667	2	6	7	2	5	16
22-11880802-G-A	0.166667	2	12	NA	NA	NA	10
22-11883053-C-T	0.083333	1	12	155	85	70	12
22-11884697-C-T	0.333333	4	12	3284	1764	1520	43
22-11885281-A-G	0.166667	2	12	20	12	8	21
22-11885882-CAA-C	0.25	3	7	45	27	18	20
22-11886244-C-T	0.333333	4	12	300	144	156	35
22-11886978-C-T	0.166667	2	8	816	423	393	14
22-11887042-G-A	0.166667	2	12	38	16	22	11
22-11888865-C-A	0.083333	1	12	NA	NA	NA	32
22-11890848-C-T	0.166667	2	12	305	172	133	13
22-11892543-A-G	0.333333	4	12	4	1	3	40
22-11892991-G-A	0.333333	4	12	78	39	39	52
22-11893230-G-C	0.833333	10	12	49113	25398	23715	52
22-11895109-T-G	0.833333	10	12	42591	22090	20501	49
22-11898268-C-G	0.833333	10	12	49972	25667	24305	59
22-11900826-G-A	0.333333	4	12	3309	1765	1544	53
22-11902662-A-T	0.25	3	12	77	40	37	24
22-11904282-C-T	0.166667	2	12	4	0	4	10
22-11904408-T-C	0.166667	2	8	76	42	34	27
22-11906559-T-A	0.25	3	12	1358	703	655	41
22-11906621-G-A	0.166667	2	12	3	1	2	15
22-11906643-T-C	0.166667	2	12	3	1	2	10
22-11907054-C-T	0.416667	5	8	13181	7070	6111	21
22-11907092-G-T	0.416667	5	8	13113	7034	6079	26
22-11907106-G-A	0.25	3	4	13309	7116	6193	22
22-11907305-G-A	0.333333	4	6	12201	6615	5586	23
22-11907350-C-A	0.333333	4	8	6832	3766	3066	30
22-11908910-T-A	0.166667	2	4	9702	5256	4446	19
22-11908999-G-A	0.166667	2	2	12741	6873	5868	11
22-11909536-A-G	0.25	3	4	2504	1387	1117	23
22-11909571-A-G	0.166667	2	2	5519	2991	2528	29
22-11909796-G-C	0.166667	2	2	12219	6547	5672	27
22-11909922-G-T	0.166667	2	8	31	18	13	26
22-11910029-T-C	0.166667	2	2	1101	623	478	15
22-11910352-A-C	0.166667	2	12	429	242	187	12
22-11910608-G-A	0.166667	2	4	23	11	12	18
22-11910611-G-A	0.166667	2	2	23	11	12	21
22-11910652-C-T	0.166667	2	10	0	0	0	19
22-11910653-A-G	0.166667	2	10	0	0	0	18
22-11910883-T-C	0.166667	2	4	1	1	0	11
22-11910937-C-T	0.166667	2	12	0	0	0	11
22-11912481-T-C	0.166667	2	8	134	69	65	18
22-11912506-T-A	0.25	3	12	17	8	9	12
22-11913145-C-G	0.833333	10	12	38037	19813	18224	34
22-11913273-C-A	0.166667	2	6	4	2	2	15
22-11913340-C-T	0.166667	2	6	13	6	7	17
22-11913471-T-C	0.166667	2	2	3288	1785	1503	24
22-11913585-C-T	0.166667	2	4	109	52	57	19
22-11913858-G-C	0.166667	2	8	0	0	0	15
22-11913861-G-A	0.166667	2	8	0	0	0	19
22-11913869-G-C	0.166667	2	6	1	0	1	15
22-11913891-C-A	0.083333	1	10	0	0	0	26
22-11914035-T-G	0.833333	10	12	49053	25277	23776	55
22-11914064-G-A	0.083333	1	12	157	96	61	28
22-11914332-T-A	0.166667	2	12	1299	716	583	50
22-11915213-G-A	0.166667	1	4	7	4	3	10
22-11915217-T-A	0.166667	2	2	151	88	63	15
22-11915790-T-A	0.166667	2	6	49	27	22	11
22-11915838-C-A	0.166667	2	6	2	1	1	10
22-11916689-C-T	0.833333	10	12	53541	27436	26105	61
22-11918109-A-G	0.166667	2	10	529	286	243	18
22-11918230-C-A	0.333333	4	8	345	189	156	27
22-11918232-G-A	0.166667	2	2	6	2	4	19
22-11918270-G-A	0.166667	2	4	1912	998	914	20
22-11918272-A-G	0.166667	2	4	4	2	2	30
22-11918343-T-C	0.166667	2	12	1486	811	675	16
22-11918612-C-T	0.25	3	6	13770	7378	6392	21
22-11918654-T-G	0.833333	10	10	51101	26016	25085	46
22-11918730-G-A	0.25	3	4	2818	1514	1304	28
22-11918835-G-A	0.25	3	4	9445	5219	4226	29
22-11919717-C-T	0.166667	2	2	91	40	51	10
22-11919810-C-T	0.166667	2	12	19	10	9	21
22-11919820-G-A	0.166667	2	12	14	7	7	13
22-11919834-C-T	0.166667	2	10	5	1	4	13
22-11920470-A-G	0.166667	2	8	8972	5004	3968	16
22-11920764-C-T	0.166667	2	8	4	1	3	12
22-11921411-G-A	0.166667	2	6	1229	653	576	14
22-11921541-A-T	0.166667	2	4	1990	1063	927	14
22-11921562-CA-C	0.166667	2	10	67	36	31	14
22-11922770-T-C	0.166667	2	10	863	451	412	19
22-11922866-T-C	0.166667	2	12	81	53	28	61
22-11924255-C-T	0.166667	2	6	1485	817	668	11
22-11924278-C-T	0.166667	2	10	2067	1095	972	15
22-11924334-G-A	0.166667	2	10	2724	1403	1321	16
22-11924451-T-C	0.25	3	4	2137	1079	1058	13
22-11924709-T-C	0.166667	2	6	2333	1214	1119	13
22-11924716-A-T	0.166667	2	4	2239	1158	1081	14
22-11924904-T-C	0.166667	2	10	17475	9313	8162	17
22-11924916-C-T	0.166667	2	12	292	166	126	21
22-11924980-A-G	0.166667	2	12	376	216	160	12
22-11925016-A-G	0.166667	2	12	460	267	193	29
22-11925069-T-C	0.166667	2	12	774	455	319	15
22-11925070-T-A	0.166667	2	12	765	451	314	16
22-11925100-T-C	0.166667	2	12	481	282	199	15
22-11925117-T-C	0.166667	2	12	237	128	109	18
22-11925137-A-G	0.166667	2	6	14234	7688	6546	23
22-11925198-C-T	0.166667	2	8	388	225	163	31
22-11925199-A-G	0.166667	2	8	382	222	160	30
22-11925391-T-C	0.166667	2	10	118	67	51	11
22-11925455-T-C	0.166667	2	10	136	81	55	14
22-11925827-G-A	0.166667	2	12	1	0	1	11
22-11925834-G-A	0.166667	2	12	0	0	0	15
22-11925854-G-A	0.166667	2	12	2	0	2	15
22-11925880-T-C	0.166667	2	10	9	5	4	23
22-11925951-G-T	0.166667	2	10	132	75	57	10
22-11926091-A-C	0.166667	2	8	8857	4780	4077	15
22-11926093-G-A	0.166667	2	10	630	336	294	23
22-11926123-C-G	0.166667	2	12	187	99	88	27
22-11926144-T-C	0.166667	2	12	213	112	101	15
22-11926149-G-C	0.166667	2	12	212	108	104	10
22-11926298-T-C	0.25	3	10	443	196	247	18
22-11926519-T-G	0.166667	2	12	556	291	265	16
22-11927098-C-A	0.666667	8	12	15749	8451	7298	61
22-11927271-T-C	0.166667	2	12	1469	832	637	47
22-11927623-A-C	0.166667	2	10	4048	2159	1889	18
22-11927764-C-T	0.166667	2	12	1	1	0	23
22-11928133-A-G	0.166667	2	4	14769	7947	6822	26
22-11928349-T-G	0.166667	2	8	2995	1553	1442	17
22-11928894-T-C	0.166667	2	10	15532	8276	7256	26
22-11929106-C-G	0.166667	2	12	3355	1756	1599	19
22-11929275-T-C	0.166667	2	12	5824	3150	2674	15
22-11929296-A-G	0.166667	2	10	13439	7289	6150	31
22-11929451-C-T	0.166667	2	10	17015	8992	8023	30
22-11929845-T-C	0.166667	2	10	5739	3045	2694	28
22-11930035-G-A	0.25	3	8	1	1	0	21
22-11930064-T-A	0.166667	2	4	8	6	2	28
22-11930244-T-C	0.166667	2	8	1418	723	695	25
22-11930265-G-A	0.166667	2	10	74	32	42	18
22-11930435-G-T	0.166667	2	8	4110	2434	1676	19
22-11930456-A-G	0.166667	2	12	797	479	318	14
22-11930561-T-C	0.166667	2	10	22609	11809	10800	27
22-11930721-T-C	0.333333	4	10	16090	8563	7527	22
22-11931107-A-C	0.166667	2	4	6261	3411	2850	23
22-11931417-T-C	1	12	12	34050	18254	15796	34
22-11931751-C-T	0.166667	2	12	297	145	152	20
22-11931797-C-T	0.166667	2	2	239	117	122	26
22-11931834-T-C	0.166667	2	6	281	151	130	18
22-11931844-C-A	0.25	3	6	302	168	134	14
22-11932023-A-G	0.333333	4	6	10950	6033	4917	31
22-11932132-C-T	0.166667	2	6	2619	1376	1243	42
22-11932147-C-G	0.166667	2	4	2685	1425	1260	39
22-11932185-A-G	0.166667	2	8	1354	743	611	22
22-11932406-C-T	0.166667	2	4	2500	1314	1186	32
22-11932574-C-T	0.166667	2	6	1452	776	676	33
22-11932637-C-T	0.166667	2	10	931	538	393	15
22-11932688-A-G	0.25	3	6	15625	8254	7371	20
22-11932720-A-G	0.166667	2	10	312	199	113	16
22-11932751-T-C	0.166667	2	10	125	82	43	23
22-11932851-G-A	0.166667	2	12	7	5	2	19
22-11933042-A-C	0.416667	5	12	1295	690	605	14
22-11933153-G-A	0.166667	2	10	6271	3469	2802	20
22-11933257-T-C	0.166667	2	8	402	229	173	16
22-11933285-G-A	0.166667	2	6	844	448	396	16
22-11933529-A-G	0.166667	2	2	6037	3338	2699	20
22-11933591-T-G	0.166667	2	2	154	92	62	24
22-11933657-G-C	0.166667	2	4	208	120	88	15
22-11933665-CGGCCTTTTGTGGCCCT-C	0.166667	2	10	953	499	454	13
22-11933699-T-C	0.166667	2	10	37	24	13	10
22-11933709-T-G	0.333333	4	10	13259	7082	6177	10
22-11933713-A-G	0.25	3	12	3499	1835	1664	10
22-11933762-G-A	0.166667	2	8	15358	8164	7194	29
22-11933784-C-T	0.166667	2	12	1828	1001	827	22
22-11933811-A-G	0.166667	2	8	2215	1196	1019	34
22-11933814-C-A	0.166667	2	10	2103	1140	963	36
22-11933828-G-T	0.166667	2	12	2154	1159	995	30
22-11933841-G-A	0.166667	2	8	2348	1257	1091	31
22-11933886-C-A	0.166667	2	8	1940	1053	887	29
22-11933946-C-T	0.833333	10	10	33458	17593	15865	50
22-11934018-T-C	0.25	3	8	20120	10629	9491	22
22-11934056-C-G	0.333333	4	10	15795	8379	7416	29
22-11934277-A-G	0.166667	2	8	0	0	0	14
22-11934351-C-T	0.166667	2	10	1	0	1	16
22-11934389-G-A	0.166667	2	12	2	2	0	17
22-11934436-C-T	0.166667	2	4	206	106	100	14
22-11934539-G-C	0.166667	2	8	240	107	133	16
22-11934603-C-T	0.166667	2	10	2222	1149	1073	22
22-11935298-C-G	0.083333	1	10	10	3	7	18
22-11935497-C-T	0.166667	2	12	6	4	2	22
22-11935919-T-G	0.166667	2	8	308	158	150	20
22-11936224-A-G	0.166667	2	4	8343	4534	3809	19
22-11936570-C-T	0.166667	2	8	0	0	0	17
22-11936600-T-C	0.166667	2	12	1245	642	603	19
22-11936679-G-A	0.166667	2	6	149	79	70	12
22-11936844-C-T	0.166667	2	8	2	2	0	11
22-11936971-A-G	0.333333	4	12	2998	1653	1345	47
22-11937061-G-A	0.333333	4	12	2911	1540	1371	43
22-11937277-A-G	0.166667	2	10	0	0	0	14
22-11937445-T-C	0.25	3	12	7308	3919	3389	11
22-11937594-C-T	0.166667	2	8	0	0	0	14
22-11937898-G-A	0.083333	1	10	10823	5757	5066	10
22-11938763-A-C	0.166667	2	10	304	147	157	13
22-11938782-G-A	0.166667	2	12	344	170	174	10
22-11939681-T-C	0.833333	10	12	41024	21212	19812	46
22-11941588-A-G	0.166667	2	12	99	57	42	13
22-11941664-T-A	0.083333	1	12	51	29	22	10
22-11941680-C-A	0.166667	2	12	22	14	8	24
22-11941689-A-G	0.166667	2	12	9	6	3	10
22-11941915-G-T	0.166667	2	8	2418	1309	1109	14
22-11942032-T-C	0.166667	2	12	1793	953	840	25
22-11942039-G-T	0.166667	2	12	809	435	374	23
22-11942309-C-T	0.166667	2	8	1479	808	671	27
22-11942438-A-T	0.166667	2	6	17338	9147	8191	12
22-11942625-T-C	0.166667	2	10	7	5	2	22
22-11942654-A-T	0.166667	2	10	12199	6359	5840	17
22-11942673-G-A	0.166667	2	12	120	64	56	16
22-11942682-A-G	0.083333	1	6	14609	7740	6869	15
22-11942840-T-C	0.333333	4	12	15284	8092	7192	26
22-11942907-G-T	0.166667	2	12	0	0	0	11
22-11943105-G-A	0.166667	2	8	2	0	2	26
22-11943130-A-C	0.166667	2	10	199	108	91	22
22-11943295-A-G	0.166667	2	10	2512	1321	1191	13
22-11943370-G-C	0.166667	2	8	20880	10929	9951	18
22-11943476-G-T	0.166667	2	12	1102	601	501	22
22-11943631-A-G	0.166667	2	12	311	170	141	11
22-11943718-C-T	0.166667	2	12	1	1	0	10
22-11943738-T-C	0.166667	2	6	1	1	0	15
22-11943879-A-G	0.166667	2	10	38	22	16	17
22-11943919-A-C	0.166667	2	6	12827	6859	5968	18
22-11944130-A-AT	0.166667	2	2	105	64	41	24
22-11944190-A-C	0.166667	2	8	1019	545	474	29
22-11944204-A-G	0.083333	1	12	505	271	234	17
22-11944229-G-A	0.166667	2	4	13188	7058	6130	18
22-11944387-G-C	0.25	3	10	9	5	4	23
22-11944390-A-C	0.166667	2	8	5	3	2	23
22-11944392-A-G	0.166667	2	10	9	6	3	30
22-11944393-T-C	0.166667	2	8	3	1	2	23
22-11944421-T-C	0.166667	2	10	0	0	0	14
22-11944589-A-G	0.166667	2	12	6	3	3	18
22-11944596-C-T	0.083333	1	10	3	1	2	12
22-11944783-A-G	0.166667	2	6	166	90	76	16
22-11944809-CAA-C	0.083333	1	10	47	26	21	10
22-11944826-T-TC	0.166667	2	8	47	21	26	16
22-11944827-A-AAC	0.166667	2	7	800	436	364	29
22-11944827-A-AC	0.166667	1	7	47	21	26	29
22-11944895-T-C	0.166667	2	10	10	7	3	14
22-11944899-GT-G	0.166667	2	12	7	6	1	15
22-11944920-A-G	0.166667	2	6	6402	3528	2874	22
22-11944932-T-C	0.166667	2	8	6139	3390	2749	28
22-11944962-T-C	0.166667	2	12	0	0	0	22
22-11944963-G-A	0.166667	2	12	0	0	0	23
22-11944976-A-G	0.166667	2	12	0	0	0	22
22-11944979-G-T	0.083333	1	12	1	1	0	17
22-11945022-T-C	0.166667	2	12	0	0	0	23
22-11945025-C-T	0.166667	2	12	0	0	0	21
22-11945095-G-A	0.166667	2	12	41	19	22	26
22-11945123-G-A	0.166667	2	12	10	1	9	16
22-11945131-G-T	0.166667	2	12	8	1	7	15
22-11945133-C-T	0.166667	2	12	7	1	6	14
22-11945295-A-C	0.333333	4	12	1281	689	592	66
22-11945655-A-AT	0.083333	1	8	9034	4743	4291	10
22-11945669-CT-C	0.083333	1	8	290	154	136	19
22-11945774-G-T	0.166667	2	8	14297	7621	6676	16
22-11945825-C-A	0.166667	2	10	475	257	218	16
22-11946358-G-C	0.166667	2	12	5	1	4	12
22-11946382-T-C	0.166667	2	10	1	0	1	12
22-11946420-T-C	0.166667	2	10	11777	6346	5431	12
22-11946558-T-A	0.083333	1	6	9873	5351	4522	12
22-11946667-T-G	0.166667	2	12	54	33	21	16
22-11947639-C-T	0.083333	1	6	11043	6021	5022	12
22-11950396-C-T	0.083333	1	8	484	258	226	22
22-11950424-C-T	0.083333	1	6	14489	7690	6799	20
22-11950484-A-C	0.166667	2	4	0	0	0	11
22-11950646-T-A	0.166667	2	6	279	146	133	28
22-11950669-T-C	0.166667	2	4	11818	6400	5418	20
22-11950699-TATAC-T	0.166667	2	10	92	48	44	14
22-11950781-T-A	0.166667	2	10	0	0	0	21
22-11950938-T-TTA	0.166667	2	8	2	2	0	12
22-11951431-T-C	0.166667	2	8	8941	4734	4207	12
22-11951566-C-T	0.166667	2	8	20	11	9	13
22-11951616-A-G	0.166667	2	6	20	10	10	24
22-11951742-G-T	0.083333	1	12	0	0	0	13
22-11951752-A-G	0.25	3	10	15464	8174	7290	23
22-11951766-TAA-T	0.166667	2	9	18	9	9	20
22-11951798-C-G	0.166667	2	10	12	8	4	28
22-11951998-C-T	0.25	3	12	7706	4205	3501	13
22-11953815-C-T	0.166667	2	12	22	11	11	12
22-11953880-C-T	0.083333	1	8	11418	6142	5276	10
22-11954084-A-T	0.166667	1	12	NA	NA	NA	13
22-11954133-G-A	0.166667	2	12	44	25	19	19
22-11954192-T-G	0.166667	2	6	14976	7915	7061	10
22-11954511-G-A	0.083333	1	12	0	0	0	11
22-11954526-G-A	0.166667	2	8	57	35	22	25
22-11954726-T-C	0.166667	2	6	1523	914	609	10
22-11955303-A-G	0.166667	2	4	1	1	0	10
22-11955392-G-A	0.166667	2	12	810	440	370	25
22-11955446-C-A	0.166667	2	8	17	8	9	23
22-11955455-A-G	0.166667	2	10	19	8	11	15
22-11955480-C-T	0.083333	1	10	0	0	0	22
22-11955490-T-C	0.166667	2	12	18	7	11	16
22-11955491-G-T	0.166667	2	10	19	7	12	11
22-11955507-C-T	0.166667	2	12	35	14	21	14
22-11955519-G-A	0.166667	2	12	667	329	338	11
22-11955548-C-T	0.166667	2	12	13	7	6	16
22-11956577-C-A	0.25	3	12	467	230	237	57
22-11957675-T-C	0.166667	2	10	6	4	2	19
22-11957778-G-T	0.166667	2	10	23	11	12	15
22-11958144-A-C	0.333333	4	12	3220	1707	1513	50
22-11958769-T-C	0.166667	2	10	3381	1766	1615	15
22-11959074-A-G	0.166667	2	12	0	0	0	15
22-11959086-C-A	0.166667	2	12	1	0	1	18
22-11959188-G-A	0.166667	2	8	2	0	2	10
22-11960603-C-T	0.166667	2	12	2352	1297	1055	57
22-11962200-G-A	0.833333	10	12	50913	26072	24841	59
22-11963404-A-G	0.166667	2	12	1041	589	452	14
22-11963405-C-A	0.166667	2	12	0	0	0	12
22-11964147-G-A	0.333333	4	12	3333	1778	1555	63
22-11965991-C-T	0.666667	8	10	7659	4130	3529	58
22-11966492-G-A	0.666667	8	12	13805	7365	6440	51
22-11967816-G-A	0.166667	2	8	136	79	57	12
22-11968747-A-AAAACCAGAAACCCAAAACAATGGGAGCGTCCTGCT	0.5	6	8	11995	6291	5704	24
22-11968932-A-C	0.166667	2	10	NA	NA	NA	25
22-11968945-A-G	0.166667	2	10	0	0	0	33
22-11969006-A-G	0.25	3	12	22	13	9	29
22-11969068-G-A	0.166667	2	8	606	314	292	29
22-11969069-C-A	0.166667	2	8	2	1	1	28
22-11969074-G-T	0.166667	2	10	0	0	0	20
22-11969200-A-C	0.166667	2	12	0	0	0	20
22-11970167-G-A	0.166667	2	6	246	120	126	20
22-11970168-G-A	0.166667	2	6	237	117	120	18
22-11970200-C-T	0.25	3	6	19	8	11	37
22-11970326-C-A	0.166667	2	8	7	1	6	14
22-11970367-T-G	0.166667	2	8	12	2	10	12
22-11970384-C-T	0.166667	2	8	8	2	6	14
22-11973447-A-T	0.166667	2	12	1140	610	530	10
22-11973713-T-C	0.166667	2	4	16183	8669	7514	27
22-11973861-C-T	0.25	3	4	6801	3480	3321	29
22-11973951-T-C	0.166667	2	6	17101	9168	7933	26
22-11973974-C-G	0.25	3	6	16268	8695	7573	31
22-11973981-T-C	0.25	3	6	16559	8844	7715	28
22-11974004-A-G	0.416667	5	8	19193	10155	9038	34
22-11974034-C-T	0.166667	2	4	13110	6912	6198	28
22-11974069-G-T	0.166667	2	8	18699	9920	8779	42
22-11974074-G-A	0.166667	2	8	20911	11024	9887	42
22-11974161-A-C	0.166667	2	4	18626	9789	8837	32
22-11974641-G-T	0.166667	2	10	0	0	0	11
22-11974653-T-C	0.416667	5	10	16158	8832	7326	20
22-11974667-C-G	0.416667	5	8	12884	7148	5736	14
22-11974898-T-A	0.25	3	4	446	260	186	20
22-11975003-T-A	0.166667	2	2	11945	6620	5325	31
22-11975156-T-A	0.25	3	4	3838	2012	1826	15
22-11975162-G-C	0.333333	4	10	5928	3093	2835	12
22-11975407-G-T	0.166667	2	12	3995	2173	1822	10
22-11975467-G-A	0.166667	2	2	12248	6670	5578	32
22-11975486-G-T	0.083333	1	2	4172	2241	1931	13
22-11975512-A-C	0.25	3	4	20812	11048	9764	33
22-11975689-T-C	0.333333	4	10	15448	8231	7217	23
22-11975722-T-C	0.25	3	6	17335	9206	8129	34
22-11975783-C-T	0.166667	2	6	5675	2915	2760	26
22-11975796-C-A	0.166667	2	2	5873	2996	2877	28
22-11975999-A-G	0.166667	2	4	3458	1862	1596	13
22-11976156-T-C	0.833333	10	10	43425	22547	20878	45
22-11976458-T-G	0.25	3	12	187	97	90	17
22-11976498-T-A	0.333333	4	6	3308	1834	1474	31
22-11976697-A-G	0.166667	2	6	246	133	113	10
22-11976746-C-T	0.166667	2	8	0	0	0	11
22-11976769-G-C	0.166667	2	12	10599	5635	4964	10
22-11976815-T-G	0.166667	2	12	17084	9123	7961	24
22-11976902-G-A	0.166667	2	12	16545	8854	7691	18
22-11977035-T-C	0.333333	4	8	10658	5805	4853	16
22-11977048-CAAAAA-C	0.166667	2	6	4117	2211	1906	17
22-11977048-CAAAAAA-C	0.166667	2	6	522	267	255	17
22-11977550-G-T	0.166667	2	4	0	0	0	11
22-12027655-T-C	0.25	3	8	2979	1658	1321	21
22-12027791-G-T	0.166667	2	10	131	63	68	24
22-12027791-G-A	0.166667	2	10	72	38	34	24
22-12027795-A-T	0.5	6	10	21150	10862	10288	32
22-12028089-T-A	0.583333	7	12	25871	13040	12831	65
22-12028345-C-T	0.25	3	6	14157	6934	7223	47
22-12028384-A-G	0.166667	2	12	0	0	0	19
22-12028407-G-A	0.5	6	12	14372	7066	7306	46
22-12028935-A-G	0.5	6	10	5	4	1	11
22-12029295-T-A	0.416667	5	10	28044	14347	13697	48
22-12029314-A-G	0.166667	2	4	9611	4892	4719	19
22-12029394-A-T	0.166667	2	4	669	319	350	24
22-12031257-C-T	0.166667	2	4	5833	2890	2943	17
22-12031416-G-A	0.416667	5	10	25021	12593	12428	49
22-12031513-C-A	0.416667	5	10	11070	5429	5641	20
22-12031515-TC-T	0.416667	5	10	11389	5582	5807	19
22-12031593-A-C	0.416667	5	8	29499	14932	14567	52
22-12032184-A-T	0.416667	5	10	28212	14263	13949	62
22-12032292-A-T	0.25	3	8	20734	10358	10376	51
22-12032544-C-T	1	12	12	55845	28922	26923	58
22-12032608-T-A	0.416667	5	8	20143	10433	9710	51
22-12032976-T-C	0.083333	1	12	0	0	0	13
22-12033067-G-A	0.166667	2	4	20	6	14	23
22-12033461-A-C	0.5	6	12	7136	3423	3713	43
22-12033469-T-C	0.416667	5	10	7737	3727	4010	48
22-12034027-G-A	0.583333	7	10	10549	5451	5098	30
22-12034084-A-T	0.166667	2	10	120	49	71	19
22-12034148-C-T	0.333333	4	8	24238	12313	11925	46
22-12034167-G-T	0.5	6	12	26699	13561	13138	43
22-12034462-T-G	0.416667	5	10	2185	1054	1131	37
22-12034755-A-C	0.5	6	12	11239	5520	5719	52
22-12035100-C-T	0.5	6	12	11	5	6	23
22-12035270-G-A	0.5	6	12	14016	6862	7154	58
22-12035355-C-T	0.5	6	12	29803	15077	14726	62
22-12035704-T-A	0.5	6	12	12954	6376	6578	46
22-12035958-G-C	0.333333	4	6	26493	13431	13062	49
22-12036532-T-G	0.416667	5	8	28107	14210	13897	56
22-12036678-G-T	0.5	6	10	28191	14263	13928	45
22-12036824-C-G	1	12	12	65385	33483	31902	51
22-12038073-G-GA	0.166667	2	4	2799	1279	1520	11
22-12038277-A-G	0.166667	2	12	0	0	0	15
22-12038963-G-T	0.166667	2	6	184	101	83	10
22-12039345-T-G	0.25	3	6	6643	3367	3276	29
22-12041094-T-G	0.416667	5	10	28507	14384	14123	54
22-12041772-A-C	0.416667	5	10	28270	14282	13988	38
22-12042233-G-C	0.25	3	12	245	106	139	58
22-12042331-C-A	0.5	6	12	14060	6899	7161	61
22-12042483-A-G	0.5	6	12	12776	6277	6499	56
22-12042814-C-A	0.25	3	8	39	19	20	11
22-12043223-T-C	0.5	6	12	26567	13432	13135	53
22-12043704-T-C	0.5	6	12	14306	6989	7317	65
22-12043974-A-G	0.5	6	10	27905	14090	13815	65
22-12044119-A-G	0.333333	4	8	27660	13984	13676	62
22-12044528-G-C	0.5	6	12	8425	4279	4146	51
22-12044734-A-T	0.083333	1	4	270	142	128	10
22-12045333-A-G	0.166667	2	10	63	28	35	29
22-12045788-G-A	0.416667	5	8	27857	14115	13742	42
22-12045938-G-A	0.333333	4	6	22273	11379	10894	35
22-12046208-A-T	0.166667	2	4	23252	12123	11129	27
22-12046664-G-A	0.333333	4	10	12	6	6	21
22-12047492-A-G	0.166667	2	4	20680	10825	9855	22
22-12048656-T-C	1	12	12	75005	38443	36562	53
22-12049613-T-G	0.166667	2	12	2576	1454	1122	12
22-12050248-T-A	0.166667	2	6	14917	7817	7100	23
22-12050296-C-T	0.166667	2	6	9481	5063	4418	24
22-12050415-C-T	0.333333	4	8	11554	5796	5758	25
22-12051122-C-G	0.083333	1	10	28	14	14	15
22-12052001-C-G	0.5	6	10	17649	8790	8859	44
22-12052357-C-T	0.416667	5	12	870	438	432	45
22-12053084-A-G	0.25	3	6	28566	14480	14086	37
22-12053646-G-T	0.25	3	6	13634	6700	6934	46
22-12054076-A-T	0.416667	5	10	4746	2396	2350	34
22-12054090-A-T	0.25	3	6	4149	2106	2043	33
22-12054201-TAC-T	0.166667	2	2	269	143	126	24
22-12054341-T-C	0.166667	2	6	16270	8531	7739	17
22-12054453-G-C	0.333333	4	8	2774	1475	1299	30
22-12054947-C-T	0.25	3	8	2	1	1	12
22-12055160-C-T	0.333333	4	8	13619	6671	6948	45
22-12055486-G-A	0.166667	2	4	1860	860	1000	12
22-12055770-C-T	0.416667	5	10	13638	6675	6963	49
22-12056190-G-A	0.5	6	12	14757	7229	7528	56
22-12056786-A-T	1	12	12	75521	38678	36843	46
22-12057125-G-A	0.416667	5	10	26702	13585	13117	53
22-12057194-C-A	0.25	3	6	25821	13157	12664	41
22-12058025-T-G	0.166667	2	4	28047	14188	13859	42
22-12058484-G-T	0.25	3	6	23	12	11	13
22-12058778-C-G	0.166667	2	6	0	0	0	13
22-12058795-A-G	0.166667	2	12	0	0	0	11
22-12061316-G-T	0.333333	3	12	11	5	6	18
22-12063716-G-A	0.333333	4	12	1	0	1	30
22-12064575-A-C	0.166667	2	12	35	18	17	14
22-12064818-G-A	0.166667	2	12	11550	5778	5772	10
22-12064892-C-A	0.166667	2	12	12871	6401	6470	11
22-12064995-G-A	0.166667	2	2	4725	2415	2310	14
22-12065275-G-T	0.166667	2	10	3	2	1	10
22-12065936-G-A	0.25	3	12	9	6	3	12
22-12069538-C-G	0.166667	2	4	24	9	15	14
22-12071114-A-T	0.166667	2	6	236	121	115	12
22-12071125-C-A	0.166667	2	6	185	92	93	15
22-12071136-G-A	0.166667	2	10	106	52	54	12
22-12071156-T-G	0.166667	2	12	20	8	12	13
22-12072830-A-G	0.833333	10	12	12341	6806	5535	31
22-12073704-A-T	0.833333	10	12	9537	5227	4310	26
22-12073893-C-T	0.5	6	12	467	230	237	26
22-12076924-T-A	0.333333	4	6	265	151	114	13
22-12076932-T-G	0.166667	2	4	127	70	57	13
22-12077059-T-G	0.166667	2	12	1020	548	472	15
22-12077067-T-C	0.166667	2	12	1339	706	633	17
22-12077068-A-G	0.166667	2	12	1402	739	663	14
22-12077077-T-A	0.166667	2	12	1803	937	866	27
22-12077095-T-A	0.166667	2	12	2518	1319	1199	17
22-12077235-G-T	0.166667	2	8	3030	1571	1459	15
22-12077249-G-A	0.25	3	10	2245	1166	1079	21
22-12077269-G-T	0.166667	2	8	1780	932	848	12
22-12078365-A-G	0.833333	10	12	4732	2742	1990	33
22-12081578-A-C	0.166667	2	2	11	5	6	17
22-12081824-G-A	0.166667	2	4	0	0	0	12
22-12083465-CA-C	0.75	10	12	9082	4962	4120	25
22-12084504-A-G	0.333333	4	8	256	142	114	17
22-12087930-T-C	0.666667	8	12	13547	7458	6089	38
22-12088893-A-T	0.833333	10	12	28400	14967	13433	42
22-12090522-C-T	0.833333	10	12	10351	5543	4808	32
22-12093183-G-C	0.333333	4	8	362	170	192	16
22-12093248-G-A	0.25	3	8	390	187	203	13
22-12095073-C-CT	0.333333	4	12	213	120	93	29
22-12098324-T-C	0.833333	10	12	30865	16312	14553	51
22-12098859-C-T	0.166667	2	10	178	87	91	19
22-12099983-G-A	0.166667	2	6	10	7	3	10
22-12101563-G-A	0.833333	10	12	28311	14955	13356	38
22-12101969-C-T	0.166667	2	10	0	0	0	17
22-12101970-C-T	0.166667	2	6	0	0	0	12
22-12103180-A-C	0.833333	10	12	33455	17882	15573	50
22-12103472-TTAAGA-T	0.166667	2	12	1	0	1	28
22-12104026-G-A	0.166667	2	2	8072	4200	3872	16
22-12104426-AT-A	0.166667	1	8	128	73	55	13
22-12105536-A-G	0.166667	2	8	1	0	1	19
22-12105802-T-TTTA	0.166667	2	6	525	321	204	16
22-12107899-G-T	0.083333	1	12	302	172	130	30
22-12108571-A-C	0.666667	8	10	7201	3993	3208	41
22-12108747-A-C	0.166667	2	10	0	0	0	10
22-12109032-T-G	0.25	3	6	553	287	266	15
22-12109216-C-T	0.166667	2	10	0	0	0	15
22-12110295-T-A	0.083333	1	12	620	346	274	29
22-12111513-C-A	0.333333	4	12	2513	1313	1200	33
22-12113283-T-C	0.166667	2	10	1	1	0	10
22-12113853-C-T	0.166667	2	8	29	16	13	13
22-12114136-C-T	0.166667	2	2	8902	4730	4172	28
22-12114160-G-A	0.333333	4	4	7116	3769	3347	26
22-12114163-T-C	0.333333	4	4	6686	3516	3170	17
22-12114171-C-T	0.166667	2	4	5283	2790	2493	19
22-12114311-A-G	0.25	3	8	54	34	20	19
22-12114323-G-A	0.166667	2	4	64	38	26	18
22-12114537-T-G	0.166667	2	2	1	0	1	17
22-12114575-T-G	0.166667	2	4	0	0	0	18
22-12114622-G-A	0.166667	2	4	3	2	1	11
22-12115489-C-T	0.25	3	12	1319	729	590	34
22-12117333-C-T	0.333333	4	12	286	158	128	25
22-12117901-C-T	0.166667	2	2	4	3	1	11
22-12118109-C-T	0.166667	2	4	1	1	0	16
22-12118117-C-A	0.166667	2	4	1	1	0	16
22-12119063-G-A	0.166667	2	2	656	343	313	12
22-12119067-G-T	0.166667	2	2	571	313	258	11
22-12119817-A-C	0.166667	2	8	3	2	1	15
22-12120628-C-CAT	0.25	3	12	1074	611	463	45
22-12121118-C-T	0.166667	2	6	1408	721	687	12
22-12122193-T-A	0.166667	2	12	24	14	10	15
22-12122334-A-C	0.166667	2	12	7	4	3	14
22-12122373-T-C	0.166667	2	8	1	0	1	20
22-12122449-G-T	0.166667	2	12	0	0	0	17
22-12122659-C-A	0.166667	2	8	6	1	5	13
22-12123214-C-CT	0.083333	1	10	393	219	174	20
22-12124461-T-A	0.333333	4	10	20	10	10	10
22-12124803-T-TG	0.333333	4	8	43	27	16	20
22-12124805-T-G	0.333333	4	8	52	34	18	21
22-12125010-A-C	0.25	3	6	1	0	1	10
22-12125796-G-T	0.166667	2	4	4	2	2	12
22-12125884-T-G	0.166667	2	10	3	2	1	23
22-12125888-C-T	0.166667	2	10	2	1	1	14
22-12125889-A-G	0.166667	2	8	2	1	1	14
22-12125896-C-T	0.166667	2	12	180	96	84	17
22-12126141-C-CA	0.166667	2	12	6	1	5	13
22-12126153-T-C	0.166667	2	12	0	0	0	13
22-12126372-TTGTG-T	0.25	3	9	2405	1356	1049	17
22-12126372-TTG-T	0.166667	2	9	3773	2063	1710	17
22-12127521-C-T	0.333333	4	6	3459	1935	1524	17
22-12128700-G-T	0.083333	1	12	473	261	212	14
22-12129269-C-G	0.166667	2	8	33	15	18	13
22-12129270-A-G	0.166667	2	8	29	12	17	13
22-12129455-A-C	0.166667	2	6	3105	1623	1482	19
22-12129735-G-C	0.166667	2	2	7328	3758	3570	15
22-12130487-C-G	0.166667	2	12	1	0	1	38
22-12133678-A-G	0.166667	2	8	0	0	0	12
22-12133698-CG-C	0.166667	2	10	1043	531	512	10
22-12135841-C-T	0.833333	10	12	10966	6047	4919	25
22-12137144-C-T	0.166667	2	8	96	51	45	11
22-12138310-C-T	0.666667	8	10	11	7	4	19
22-12140129-C-T	0.083333	1	12	589	332	257	10
22-12140906-T-C	0.166667	2	8	108	45	63	15
22-12141159-C-T	0.333333	4	12	2	1	1	25
22-12142807-T-A	0.166667	2	12	1159	658	501	26
22-12145631-T-A	1	12	12	37680	19947	17733	40
22-12146223-T-C	0.166667	2	4	47	31	16	18
22-12146330-C-T	0.166667	2	12	1	1	0	13
22-12146742-TA-T	0.833333	10	12	7162	4120	3042	26
22-12147701-T-C	0.583333	7	10	11	2	9	11
22-12148191-C-T	0.166667	2	2	60	27	33	19
22-12148219-C-A	0.25	3	6	63	27	36	27
22-12150559-G-A	0.166667	2	10	99	55	44	11
22-12150906-T-A	0.166667	2	4	121	65	56	15
22-12150975-G-T	0.166667	2	4	0	0	0	11
22-12150982-G-C	0.166667	2	4	0	0	0	11
22-12152360-A-G	0.166667	2	4	14002	7180	6822	16
22-12153417-A-G	0.166667	2	4	343	193	150	18
22-12153539-C-A	0.166667	2	6	8582	4342	4240	21
22-12153693-G-T	0.25	3	6	8790	4489	4301	11
22-12154148-G-T	0.166667	2	8	512	235	277	13
22-12154281-C-T	0.333333	4	12	29	17	12	24
22-12154846-A-T	0.166667	2	8	826	455	371	13
22-12154937-C-A	0.25	3	10	173	92	81	13
22-12155439-A-G	0.25	3	8	4297	2263	2034	33
22-12155454-G-A	0.166667	2	4	4633	2453	2180	29
22-12155463-G-T	0.166667	2	8	4830	2553	2277	35
22-12155481-T-C	0.166667	2	8	9394	5005	4389	39
22-12155620-T-A	0.166667	2	6	22448	11110	11338	19
22-12155804-A-C	0.25	3	4	21963	10851	11112	19
22-12156226-T-A	0.166667	2	2	19831	9916	9915	23
22-12156378-GT-G	0.75	7	10	6163	3344	2819	25
22-12156841-C-T	0.166667	2	4	49	29	20	10
22-12158084-C-T	0.166667	2	10	2	1	1	22
22-12158087-C-T	0.166667	2	8	4	1	3	23
22-12158187-T-C	0.166667	2	6	23	17	6	23
22-12158295-T-C	0.166667	2	4	3606	1797	1809	15
22-12158300-C-G	0.166667	2	10	421	216	205	10
22-12158393-A-G	0.166667	2	4	13039	6526	6513	24
22-12158532-A-AT	0.75	8	12	3714	2041	1673	22
22-12158533-T-A	0.166667	2	4	643	331	312	16
22-12158959-T-C	0.166667	2	6	9058	4259	4799	15
22-12159468-T-C	0.166667	2	4	81	37	44	10
22-12161133-G-A	0.166667	2	12	21261	10572	10689	14
22-12161490-A-C	0.166667	2	4	6300	3336	2964	18
22-12161698-AAAACACACGGT-A	0.5	6	10	184	99	85	10
22-12161970-T-G	0.166667	2	4	22946	11405	11541	30
22-12162071-T-C	0.416667	5	6	15041	7827	7214	12
22-12162164-G-A	0.166667	2	2	8371	4480	3891	10
22-12162526-A-C	0.166667	2	2	1308	725	583	19
22-12162870-T-C	0.166667	2	10	222	111	111	11
22-12163003-A-G	0.166667	2	12	1	1	0	11
22-12163017-T-C	0.166667	2	12	0	0	0	10
22-12163082-A-C	0.166667	2	6	5	4	1	11
22-12163855-C-G	0.166667	2	8	8013	4244	3769	15
22-12164386-A-C	0.166667	2	12	0	0	0	12
22-12164387-G-A	0.166667	2	12	5	3	2	13
22-12165385-GAA-G	0.666667	8	10	120	57	63	14
22-12165538-G-A	0.666667	8	10	8912	4984	3928	54
22-12165757-T-C	0.5	6	6	147	77	70	45
22-12166253-A-G	0.25	3	4	22943	11397	11546	17
22-12166384-T-C	0.333333	4	8	10716	5568	5148	20
22-12166405-C-CT	0.333333	4	6	17452	8785	8667	15
22-12166894-G-C	0.166667	2	6	18499	9271	9228	17
22-12166943-G-A	0.166667	2	2	13189	6760	6429	19
22-12167108-A-C	0.166667	2	10	0	0	0	26
22-12167109-G-C	0.166667	2	10	0	0	0	24
22-12167113-A-C	0.166667	2	10	0	0	0	12
22-12167177-T-C	1	12	12	50832	26472	24360	51
22-12167753-C-G	0.25	3	6	6935	3596	3339	14
22-12167775-G-A	0.166667	2	2	10643	5389	5254	24
22-12167871-G-GA	0.166667	2	8	2133	1115	1018	17
22-12167949-A-C	0.166667	2	4	4277	2144	2133	20
22-12167983-A-G	0.166667	2	6	13096	6774	6322	21
22-12168026-G-A	0.166667	2	12	14948	7611	7337	12
22-12168070-G-A	0.166667	2	12	12618	6489	6129	25
22-12168116-CG-C	0.166667	2	12	5284	2922	2362	21
22-12168118-T-C	0.166667	2	12	4884	2693	2191	23
22-12168127-A-G	0.166667	2	12	4193	2308	1885	18
22-12168191-G-T	0.166667	2	2	1193	677	516	29
22-12168196-T-C	0.166667	2	2	1321	756	565	28
22-12168333-A-G	0.166667	2	4	904	486	418	22
22-12168397-A-G	0.166667	2	6	1127	609	518	18
22-12168411-A-G	0.166667	2	8	961	523	438	15
22-12168429-A-C	0.166667	2	6	929	505	424	21
22-12168523-A-G	1	12	12	22319	12055	10264	29
22-12168532-A-G	0.166667	2	2	2	1	1	15
22-12168535-G-GA	0.166667	2	6	28	18	10	11
22-12168550-G-A	0.166667	2	4	0	0	0	14
22-12169020-G-A	0.833333	10	10	10559	5863	4696	46
22-12169204-GA-G	0.083333	1	10	142	81	61	13
22-12169429-G-GA	0.083333	1	10	889	471	418	28
22-12174808-A-C	0.166667	2	8	4	2	2	10
22-12174961-T-C	0.833333	10	12	37851	20172	17679	45
22-12175335-C-A	0.166667	2	12	NA	NA	NA	27
22-12175401-G-A	0.25	3	12	18	10	8	33
22-12176785-G-A	0.166667	2	6	874	420	454	18
22-12177222-T-C	0.166667	2	8	7410	3848	3562	11
22-12178071-C-T	0.5	5	8	9387	4875	4512	19
22-12178212-G-C	0.416667	5	6	4829	2567	2262	14
22-12178240-C-A	0.5	6	8	8217	4388	3829	27
22-12178293-A-C	0.083333	1	10	1	1	0	14
22-12178595-T-C	0.166667	2	2	25766	13274	12492	11
22-12178873-T-G	0.166667	2	8	2863	1484	1379	13
22-12178880-A-T	0.166667	2	8	2498	1303	1195	13
22-12179201-G-A	0.833333	9	12	28782	15164	13618	51
22-12179257-G-C	0.166667	2	4	16	13	3	17
22-12179302-C-T	0.166667	2	6	44	27	17	12
22-12180294-C-G	0.25	3	8	8573	4598	3975	20
22-12180326-C-A	0.416667	5	8	8351	4393	3958	22
22-12180334-C-A	0.25	3	4	8359	4434	3925	17
22-12180354-CA-C	0.166667	2	4	10122	5412	4710	17
22-12180385-T-G	0.166667	2	4	14659	7680	6979	20
22-12180511-A-G	0.166667	2	6	0	0	0	10
22-12180515-CA-C	0.666667	9	12	4558	2482	2076	27
22-12180540-G-A	0.833333	10	12	8081	4621	3460	28
22-12181459-A-C	0.833333	10	12	21568	11322	10246	49
22-12181632-CA-C	0.166667	2	10	3	1	2	23
22-12181694-C-A	0.083333	1	10	41	19	22	10
22-12181714-G-A	0.166667	2	4	20543	10336	10207	32
22-12181878-A-T	0.166667	2	4	12068	6264	5804	22
22-12182763-T-C	0.166667	2	12	7347	3853	3494	13
22-12182813-A-G	0.166667	2	12	2068	1041	1027	19
22-12182873-C-G	0.166667	2	10	1	1	0	13
22-12183114-C-T	0.166667	2	6	50	20	30	17
22-12184957-G-A	0.333333	4	12	27	15	12	19
22-12185313-C-A	0.166667	2	8	220	95	125	12
22-12185336-C-G	0.166667	2	8	12464	6424	6040	22
22-12186121-T-C	1	12	12	8773	4848	3925	31
22-12186184-C-T	0.166667	2	4	4	2	2	12
22-12186602-A-G	0.166667	2	6	2139	1052	1087	12
22-12186649-T-A	0.166667	2	4	1138	572	566	16
22-12187449-G-A	0.166667	2	10	1365	764	601	39
22-12188430-G-T	0.833333	10	12	6061	3388	2673	43
22-12188566-T-A	0.166667	2	6	232	115	117	10
22-12188586-A-T	0.166667	2	4	1167	641	526	23
22-12188956-C-T	0.083333	1	10	4	1	3	15
22-12188999-T-C	0.166667	2	10	213	122	91	14
22-12189062-G-T	0.166667	2	8	95	60	35	13
22-12189485-C-T	0.333333	4	6	12867	6866	6001	43
22-12189558-C-T	0.25	3	6	226	120	106	17
22-12189716-A-C	0.166667	2	4	23235	11546	11689	44
22-12189735-G-T	0.083333	1	4	580	319	261	17
22-12189845-A-G	0.083333	1	4	11	4	7	10
22-12190506-A-T	0.166667	2	2	27451	13679	13772	40
22-12191590-T-C	0.166667	2	6	23630	11720	11910	33
22-12194264-C-G	1	12	12	74915	38399	36516	40
22-12194631-A-G	0.166667	2	4	23258	11552	11706	27
22-12194714-C-T	0.25	3	6	1159	530	629	30
22-12194752-A-C	0.166667	2	4	22714	11322	11392	48
22-12195834-A-G	0.25	3	6	3764	1830	1934	48
22-12196019-G-T	1	12	12	46383	24596	21787	43
22-12196062-G-T	0.25	3	6	8089	4348	3741	19
22-12196139-C-G	0.166667	2	6	9389	4534	4855	24
22-12196225-T-A	0.333333	4	8	21017	10497	10520	38
22-12196230-T-G	0.333333	4	8	7068	3362	3706	36
22-12196520-T-C	0.5	6	12	19046	9614	9432	42
22-12196578-C-T	0.416667	5	10	19232	9705	9527	31
22-12196641-GTA-G	0.333333	3	6	9448	5311	4137	17
22-12196641-GTATA-G	0.083333	1	1	101	53	48	12
22-12196645-A-G	0.416667	5	6	10975	5581	5394	15
22-12196796-T-C	0.25	3	10	8984	4684	4300	10
22-12197371-A-G	0.25	3	6	23604	11710	11894	47
22-12197517-A-G	0.25	3	6	23582	11688	11894	44
22-12197735-C-G	0.25	3	6	23417	11613	11804	32
22-12198124-A-G	0.25	3	6	14086	7432	6654	28
22-12198136-A-G	0.416667	5	10	17095	8862	8233	40
22-12198294-G-C	0.25	3	8	22581	11263	11318	34
22-12198330-A-G	0.333333	4	8	23125	11496	11629	44
22-12198682-T-C	0.25	3	4	25192	12497	12695	44
22-12198985-G-T	0.166667	2	4	24546	12232	12314	25
22-12198986-A-C	0.166667	2	4	24530	12235	12295	26
22-12199496-T-C	0.333333	4	6	22157	11046	11111	38
22-12199587-T-G	0.083333	1	12	0	0	0	14
22-12199872-A-G	0.333333	4	8	22918	11398	11520	29
22-12200085-G-A	0.166667	2	10	19695	9823	9872	25
22-12200181-A-G	0.166667	2	6	1276	683	593	14
22-12200553-C-A	0.25	3	6	22522	11148	11374	28
22-12200648-C-T	0.166667	2	6	500	222	278	17
22-12200998-T-C	0.416667	5	10	18235	9310	8925	35
22-12201495-T-C	0.25	3	8	25669	12837	12832	50
22-12202808-C-T	0.416667	5	10	887	394	493	31
22-12202933-G-A	0.5	6	12	2027	890	1137	47
22-12203404-T-C	0.166667	2	8	1150	615	535	25
22-12203653-C-T	0.25	3	8	5726	2989	2737	38
22-12204585-TA-T	0.166667	2	4	19298	9536	9762	21
22-12204789-A-T	0.333333	4	8	211	91	120	21
22-12205731-A-G	0.166667	2	6	27475	13797	13678	19
22-12205915-T-A	0.333333	4	8	1	1	0	11
22-12206265-A-G	0.25	3	6	23395	11606	11789	36
22-12206405-G-T	0.166667	2	12	0	0	0	10
22-12206619-C-T	0.166667	2	4	26951	13532	13419	43
22-12207018-T-C	0.083333	1	12	103	54	49	31
22-12207153-G-A	0.25	3	6	17	5	12	11
22-12207308-T-C	0.5	6	12	6	4	2	15
22-12208085-G-C	0.166667	2	4	23917	11839	12078	43
22-12208087-T-G	0.166667	2	4	23900	11826	12074	43
22-12208417-T-C	0.166667	2	6	29370	14804	14566	32
22-12208586-G-A	0.333333	4	8	23430	11627	11803	56
22-12208620-T-A	0.083333	1	4	3	1	2	22
22-12209010-A-G	0.25	3	6	21841	10878	10963	40
22-12209214-C-A	0.166667	2	10	39	23	16	24
22-12209227-A-C	0.25	3	6	26865	13493	13372	45
22-12209250-TA-T	0.166667	2	12	11	4	7	14
22-12209253-C-G	0.166667	2	10	15	6	9	11
22-12209501-A-ATTAT	0.416667	5	10	6196	3000	3196	31
22-12210127-T-C	0.416667	5	10	26813	13592	13221	32
22-12210231-A-T	0.25	3	6	1948	937	1011	26
22-12210610-C-T	0.5	6	12	49	19	30	24
22-12210680-C-T	0.416667	5	10	6	4	2	26
22-12210837-C-G	0.5	6	12	6	2	4	33
22-12210946-C-T	0.25	3	12	0	0	0	24
22-12211521-G-A	0.5	6	12	26262	13339	12923	31
22-12211681-A-C	0.166667	2	4	22951	11358	11593	42
22-12212187-A-G	0.416667	5	10	2311	1127	1184	31
22-12212244-G-C	0.333333	4	8	1234	597	637	18
22-12212380-A-C	0.5	6	12	12090	5909	6181	35
22-12212485-C-A	0.25	3	6	17576	8766	8810	41
22-12212558-A-T	0.333333	4	8	20474	10220	10254	46
22-12212570-A-G	0.416667	5	10	24089	12189	11900	47
22-12213083-A-G	0.416667	5	10	20934	10472	10462	46
22-12213812-T-C	0.166667	2	4	1151	648	503	20
22-12213832-A-C	0.166667	2	6	3623	1990	1633	28
22-12214066-C-T	0.416667	5	10	12673	6537	6136	22
22-12214221-C-CTT	0.333333	5	10	1122	640	482	13
22-12214321-T-C	0.25	3	10	3834	2096	1738	11
22-12214418-C-T	0.5	6	12	1391	657	734	20
22-12214576-A-G	0.333333	4	10	14581	7484	7097	18
22-12214726-A-G	0.416667	5	10	34	17	17	47
22-12214940-C-T	0.166667	2	10	12371	6388	5983	33
22-12214966-A-T	0.416667	5	10	21637	11206	10431	38
22-12215369-T-G	0.083333	1	4	16	7	9	13
22-12215543-A-G	0.083333	1	12	0	0	0	31
22-12215621-CT-C	0.166667	2	10	79	40	39	22
22-12215628-G-A	0.166667	2	8	710	361	349	20
22-12215794-A-G	0.333333	4	6	22282	11485	10797	22
22-12216273-T-G	0.166667	2	8	3668	2029	1639	29
22-12216923-C-A	0.5	6	12	18548	9249	9299	36
22-12217149-G-A	0.333333	4	8	16982	8935	8047	39
22-12217168-T-A	0.25	3	6	10688	5573	5115	37
22-12217304-G-T	0.166667	2	6	21949	11229	10720	39
22-12217388-C-T	0.416667	5	10	15867	7961	7906	35
22-12217474-C-T	0.333333	4	8	18638	9343	9295	40
22-12217652-G-A	0.25	3	6	20349	10127	10222	51
22-12217772-A-T	0.416667	5	10	21068	10455	10613	45
22-12218060-A-AT	0.166667	2	6	9302	4952	4350	16
22-12218323-A-C	0.166667	2	8	25929	13309	12620	22
22-12218544-C-T	0.166667	2	6	22812	11310	11502	24
22-12218691-A-C	0.166667	2	4	22697	11221	11476	29
22-12219007-C-G	0.25	3	8	0	0	0	16
22-12219262-T-C	0.166667	2	4	22624	11175	11449	15
22-12219423-C-T	0.5	6	12	205	89	116	14
22-12219941-C-A	0.333333	4	8	58	24	34	20
22-12220105-G-A	0.333333	4	8	0	0	0	22
22-12221154-G-T	0.416667	5	10	2979	1411	1568	19
22-12221274-G-A	0.333333	4	8	641	267	374	22
22-12221441-C-CTGTG	0.416667	5	10	6847	3378	3469	26
22-12221901-C-G	0.25	3	6	22894	11365	11529	31
22-12222289-T-A	0.166667	2	4	20579	10280	10299	20
22-12223470-G-A	0.5	6	12	17138	8548	8590	31
22-12223688-T-C	0.083333	1	12	1	1	0	14
22-12223689-G-A	0.25	3	6	20231	10091	10140	43
22-12224004-G-A	0.5	6	12	21167	10496	10671	42
22-12224266-A-C	0.416667	5	10	17054	8592	8462	45
22-12224520-T-C	0.333333	4	8	8048	4272	3776	37
22-12224676-C-A	0.333333	4	10	1333	596	737	16
22-12276165-G-C	0.166667	2	6	3266	1599	1667	16
22-12276199-C-T	0.5	6	6	9383	4541	4842	16
22-12276215-A-T	0.416667	6	6	13613	6770	6843	14
22-12276386-C-G	0.5	6	8	9148	4455	4693	15
22-12277008-G-A	0.25	3	6	2228	1201	1027	26
22-12277557-T-C	0.166667	2	2	17460	9251	8209	30
22-12278215-C-A	0.083333	1	12	232	117	115	14
22-12278260-T-C	0.333333	4	12	563	271	292	13
22-12280181-G-A	0.25	3	10	414	212	202	20
22-12280668-T-G	0.5	6	10	24485	12568	11917	37
22-12280973-C-G	0.583333	7	12	25161	12905	12256	48
22-12281830-A-T	0.416667	5	8	893	505	388	13
22-12281951-G-T	0.333333	4	4	7097	3687	3410	19
22-12282014-A-G	0.333333	4	8	1822	938	884	16
22-12282086-C-G	0.5	6	8	1220	606	614	22
22-12282093-A-C	0.333333	4	8	1274	622	652	12
22-12282118-T-C	0.666667	8	8	3187	1527	1660	20
22-12282183-T-C	0.333333	4	4	12168	6083	6085	11
22-12282885-T-G	0.333333	4	10	4539	2491	2048	16
22-12284924-A-G	0.166667	2	8	3462	1680	1782	24
22-12285033-G-A	0.166667	2	6	10	4	6	14
22-12285994-A-C	0.166667	2	12	186	90	96	15
22-12286096-G-A	0.166667	2	10	78	40	38	11
22-12287063-A-C	0.333333	4	12	610	344	266	15
22-12292817-A-C	0.166667	2	2	22511	11609	10902	32
22-12292846-A-G	0.166667	2	10	170	89	81	21
22-12293377-CTTCTTTCT-C	0.083333	1	2	13	10	3	17
22-12293525-CCCTTT-C	0.333333	3	7	33	19	14	18
22-12293970-A-G	0.083333	1	8	0	0	0	12
22-12293984-A-C	0.25	3	4	0	0	0	19
22-12297412-G-T	0.083333	1	12	350	153	197	13
22-12298192-G-T	0.333333	4	6	104	44	60	18
22-12298352-C-T	0.083333	1	12	1671	881	790	20
22-12298700-G-A	0.333333	4	12	1601	823	778	17
22-12298910-G-A	0.333333	4	12	62	32	30	16
22-12300832-C-A	0.25	3	8	0	0	0	11
22-12301411-A-G	0.166667	2	6	10	5	5	15
22-12301422-A-C	0.166667	2	2	4	3	1	10
22-12302280-A-G	0.166667	2	12	41	25	16	17
22-12302600-C-A	0.333333	4	6	12923	6932	5991	38
22-12303078-A-G	0.25	3	6	7772	4246	3526	18
22-12304118-G-A	0.416667	5	8	23021	11863	11158	23
22-12304225-G-T	0.166667	1	2	12193	6339	5854	13
22-12306581-CT-C	0.083333	1	1	0	0	0	11
22-12309709-T-TTTCC	0.166667	2	8	43	14	29	11
22-12310892-C-T	0.25	3	12	8696	4306	4390	45
22-12311615-G-T	0.5	6	10	124	60	64	11
22-12312466-A-C	0.166667	2	10	2968	1606	1362	23
22-12312540-C-T	0.333333	4	6	1741	935	806	14
22-12312589-G-GCC	0.166667	2	2	2	2	0	11
22-12312599-A-T	0.166667	2	2	918	464	454	16
22-12313039-A-G	0.333333	4	8	58868	30224	28644	23
22-12313743-CTTATTTAT-C	0.083333	1	10	8	4	4	11
22-12313849-A-C	0.416667	5	8	35032	17754	17278	23
22-12314740-T-C	0.083333	1	12	547	284	263	36
22-12314765-G-A	0.25	3	12	11421	5773	5648	61
22-12315254-G-T	0.5	6	10	12453	6689	5764	43
22-12315331-G-T	0.583333	7	12	21212	11056	10156	44
22-12315560-T-C	0.166667	2	12	536	260	276	34
22-12315833-G-A	0.166667	2	12	9	4	5	22
22-12316654-T-C	0.166667	2	12	1265	657	608	17
22-12318474-C-T	0.333333	4	6	14736	7914	6822	27
22-12318519-G-A	0.083333	1	12	1159	617	542	11
22-12319181-C-T	0.166667	2	12	1466	680	786	18
22-12319317-A-C	0.5	6	10	24014	12319	11695	52
22-12319349-T-G	0.416667	5	12	455	234	221	25
22-12319467-G-T	0.083333	1	12	1	0	1	11
22-12319812-A-C	0.166667	2	12	41	15	26	24
22-12321743-C-T	0.166667	2	12	1	0	1	25
22-12322531-T-C	0.166667	2	6	26225	13371	12854	23
22-12325290-G-T	0.583333	7	8	2661	1333	1328	20
22-12325300-C-T	0.75	9	10	2846	1444	1402	18
22-12326917-A-T	1	12	12	3475	1960	1515	25
22-12327428-C-T	0.166667	2	8	24196	12314	11882	13
22-12327846-G-T	0.5	6	10	1	1	0	20
22-12328351-G-A	0.833333	10	12	2921	1508	1413	27
22-12329030-G-C	0.333333	4	12	933	465	468	11
22-12329853-T-C	0.083333	1	12	3900	1999	1901	21
22-12331047-T-G	0.166667	2	12	4262	2048	2214	19
22-12333157-A-G	0.583333	7	12	25907	13225	12682	40
22-12333208-C-G	0.166667	2	12	4381	2159	2222	18
22-12333729-C-A	0.333333	4	12	1387	703	684	11
22-12334471-C-A	0.166667	2	12	0	0	0	15
22-12334658-T-C	0.083333	1	4	715	349	366	11
22-12334736-T-C	0.5	6	10	83	46	37	32
22-12336252-T-C	0.25	3	4	382	214	168	10
22-12336262-T-A	0.333333	3	4	407	215	192	13
22-12336593-G-C	0.166667	2	6	1213	589	624	18
22-12340980-G-A	0.083333	1	12	292	145	147	23
22-12341604-A-G	0.333333	4	12	10	6	4	23
22-12342025-G-A	0.166667	2	12	8	3	5	20
22-12342508-A-G	0.333333	4	6	17122	8759	8363	46
22-12343173-C-T	0.25	3	6	38	19	19	10
22-12343517-G-A	0.166667	2	12	0	0	0	12
22-12343893-T-C	0.5	6	10	18621	9790	8831	52
22-12343978-C-T	0.333333	4	12	671	329	342	31
22-12344401-G-A	0.083333	1	12	635	325	310	14
22-12346031-G-A	0.166667	2	2	3920	2170	1750	18
22-12346961-G-A	0.083333	1	8	1288	667	621	10
22-12347932-A-G	0.166667	2	12	8	3	5	18
22-12348286-T-A	0.166667	2	12	5060	2514	2546	23
22-12349318-G-T	0.166667	2	4	308	191	117	13
22-12349521-A-G	0.166667	2	8	260	146	114	15
22-12350295-G-A	0.5	6	10	0	0	0	10
22-12351063-G-A	0.333333	4	6	25817	13205	12612	38
22-12352464-C-A	0.333333	4	12	56	31	25	13
22-12353976-A-G	0.833333	10	10	41	25	16	17
22-12353982-C-T	0.666667	8	8	228	127	101	15
22-12354042-T-C	0.333333	4	4	1694	888	806	14
22-12356805-A-T	0.083333	1	12	1637	856	781	10
22-12360140-A-G	0.166667	2	8	40	20	20	12
22-12361477-A-G	0.333333	4	8	54944	28418	26526	34
22-12364405-A-G	0.166667	2	10	0	0	0	10
22-12364503-G-C	0.583333	7	12	192	95	97	25
22-12364518-T-C	0.666667	7	12	154	80	74	19
22-12364525-T-A	0.333333	4	10	0	0	0	10
22-12364630-C-T	0.25	3	4	20139	10595	9544	28
22-12365017-T-C	0.333333	4	12	28	12	16	31
22-12365688-G-C	0.5	6	10	3340	1622	1718	26
22-12365721-G-A	0.333333	4	12	238	119	119	28
22-12365869-C-T	0.166667	2	6	1014	552	462	20
22-12365968-C-T	0.25	3	4	592	314	278	26
22-12366317-C-T	0.166667	2	6	9085	4863	4222	15
22-12366614-C-T	0.25	3	4	58	22	36	11
22-12366706-A-G	0.666667	7	10	463	233	230	12
22-12366748-C-T	1	12	12	58614	31535	27079	42
22-12366755-A-G	0.416667	5	10	81	39	42	20
22-12370288-G-A	0.166667	2	8	2	1	1	12
22-12370360-A-G	0.083333	1	12	7	5	2	13
22-12370627-C-T	0.083333	1	12	8	5	3	52
22-12370677-C-T	0.333333	4	12	23	10	13	27
22-12371965-T-C	0.166667	2	2	25695	13145	12550	23
22-12372797-A-T	0.166667	2	8	1547	889	658	28
22-12372879-G-C	0.166667	2	8	4210	2209	2001	28
22-12373089-A-G	0.166667	2	4	7847	4069	3778	26
22-12373105-C-T	0.166667	2	10	46	22	24	12
22-12374615-A-C	0.166667	2	4	25	17	8	16
22-12375592-AT-A	0.333333	4	8	152	69	83	11
22-12375772-T-C	0.416667	5	10	12	6	6	20
22-12375963-G-C	0.083333	1	12	1	0	1	13
22-12376021-A-C	1	12	12	75747	38780	36967	52
22-12376032-C-T	0.166667	2	8	1	0	1	15
22-12376568-C-T	0.416667	5	10	16	7	9	14
22-12376622-C-T	0.333333	4	8	13	6	7	14
22-12376909-G-C	0.583333	7	12	26495	13476	13019	60
22-12376945-C-T	0.083333	1	2	13	6	7	11
22-12377061-A-T	0.083333	1	2	163	75	88	14
22-12377482-G-C	0.25	3	6	16	8	8	19
22-12377588-C-A	0.666667	8	12	52873	27242	25631	59
22-12377642-C-T	0.25	3	6	157	71	86	26
22-12378537-C-T	0.166667	2	2	26558	13520	13038	39
22-12378786-A-G	0.666667	8	12	37948	19570	18378	33
22-12378992-G-A	0.416667	5	10	1	0	1	20
22-12379770-A-G	0.166667	2	2	29026	14837	14189	40
22-12380175-A-T	0.5	6	12	16	7	9	23
22-12381305-T-C	0.25	3	4	25100	12716	12384	48
22-12381310-A-G	0.166667	2	2	25091	12710	12381	50
22-12381342-T-C	0.083333	1	10	15	6	9	24
22-12381913-TA-T	0.25	3	6	281	129	152	20
22-12381937-GA-G	0.25	3	8	37	23	14	10
22-12382595-G-T	0.416667	5	8	386	208	178	13
22-12384102-G-A	0.25	3	4	26419	13440	12979	51
22-12384661-T-C	0.5	6	12	164	76	88	28
22-12385710-A-G	0.583333	7	12	26596	13536	13060	55
22-12386135-A-G	0.583333	7	12	26582	13524	13058	55
22-12386374-C-T	0.583333	7	12	26345	13408	12937	56
22-12386502-C-T	0.083333	1	6	0	0	0	10
22-12387369-A-G	0.25	3	10	21349	10993	10356	44
22-12388624-C-T	0.25	3	6	7	3	4	14
22-12388987-T-C	0.416667	5	10	164	77	87	15
22-12389097-G-A	0.25	3	6	0	0	0	12
22-12389567-A-G	0.5	6	10	26504	13485	13019	49
22-12389799-A-G	0.333333	4	8	160	73	87	10
22-12389826-C-T	0.416667	5	10	162	75	87	15
22-12390209-C-T	0.083333	1	2	0	0	0	11
22-12390906-G-A	0.166667	2	4	12	5	7	11
22-12391861-T-A	0.25	3	6	76	40	36	35
22-12392787-A-C	0.666667	7	12	9697	5096	4601	37
22-12393389-T-C	0.5	6	12	167	76	91	14
22-12393470-A-G	0.083333	1	10	4	1	3	23
22-12393512-T-A	1	12	12	76115	38930	37185	54
22-12393740-T-A	0.25	3	6	0	0	0	10
22-12393826-A-G	0.166667	2	8	0	0	0	11
22-12394046-G-T	0.5	6	12	164	75	89	22
22-12394077-A-T	0.416667	5	10	15	8	7	34
22-12394848-C-T	0.333333	4	6	28274	14433	13841	43
22-12397293-A-G	0.416667	5	8	26483	13474	13009	48
22-12397896-A-C	0.166667	2	6	7001	3466	3535	10
22-12398030-C-T	0.25	3	6	6567	3267	3300	14
22-12398518-C-G	0.25	3	4	26427	13456	12971	42
22-12398539-G-T	0.166667	2	10	49	19	30	17
22-12398567-C-A	0.25	3	12	35	20	15	15
22-12398736-A-T	0.083333	1	10	8	3	5	10
22-12398801-C-T	0.416667	5	8	26489	13488	13001	47
22-12399050-T-C	1	12	12	75432	38621	36811	53
22-12399745-C-A	0.25	3	4	26467	13470	12997	45
22-12400368-C-T	0.416667	5	10	167	75	92	14
22-12402715-A-G	0.333333	4	4	57210	29238	27972	26
22-12402744-A-G	0.166667	2	10	26569	13532	13037	23
22-12403137-G-A	0.166667	2	4	0	0	0	12
22-12404856-A-T	0.416667	5	10	43	22	21	15
22-12405309-G-A	0.5	6	10	26745	13613	13132	52
22-12406286-G-A	0.333333	4	8	138	72	66	14
22-12406387-C-A	0.583333	7	12	17042	8533	8509	36
22-12407003-T-G	0.083333	1	10	6	2	4	11
22-12407494-A-G	0.5	6	12	297	134	163	19
22-12407531-A-AT	0.5	6	12	194	90	104	24
22-12407668-T-C	0.666667	7	12	26656	13559	13097	57
22-12407760-G-A	0.416667	5	10	305	144	161	29
22-12407843-C-T	0.5	6	12	25	12	13	27
22-12408071-T-C	0.583333	7	12	26775	13621	13154	60
22-12408258-G-A	0.416667	5	10	200	89	111	15
22-12408310-C-CT	0.333333	4	6	26759	13622	13137	49
22-12409132-C-CT	0.5	6	12	185	86	99	34
22-12409214-G-A	0.083333	1	6	87	40	47	25
22-12409228-T-C	0.166667	2	6	44	20	24	26
22-12409242-G-A	0.416667	5	8	26740	13616	13124	54
22-12409367-A-G	0.5	6	12	193	88	105	16
22-12410930-C-A	0.583333	7	12	8	4	4	10
22-12411350-T-C	0.333333	4	8	287	135	152	14
22-12413267-C-T	0.333333	4	6	19	10	9	29
22-12413293-T-G	0.166667	2	4	26692	13596	13096	50
22-12413977-T-C	0.5	6	10	26743	13619	13124	52
22-12415551-AGTTTGGAGCCCATC-A	0.166667	2	12	0	0	0	13
22-12415590-AT-A	0.25	3	6	4	3	1	11
22-12416170-G-A	0.166667	2	2	26687	13600	13087	54
22-12416642-C-T	0.333333	4	8	0	0	0	25
22-12417283-A-ACTTTT	0.333333	4	6	25100	12895	12205	32
22-12418064-G-A	0.583333	7	12	26752	13612	13140	44
22-12418673-G-C	0.083333	1	2	1414	749	665	13
22-12418835-G-T	0.083333	1	4	2352	1218	1134	10
22-12418844-G-C	0.083333	1	2	2356	1216	1140	13
22-12419133-T-G	0.5	6	10	26462	13482	12980	51
22-12420649-T-G	0.166667	2	2	27069	13749	13320	44
22-12421218-T-C	0.333333	4	8	5	2	3	12
22-12421600-T-G	0.083333	1	2	2889	1490	1399	34
22-12422560-A-G	0.166667	2	2	26754	13616	13138	46
22-12423485-C-T	0.25	3	6	340	167	173	32
22-12423666-C-T	0.333333	4	8	1356	680	676	22
22-12423972-T-C	0.333333	4	8	1187	598	589	41
22-12424208-AT-A	0.5	6	12	1631	845	786	50
22-12424459-G-GAA	0.083333	1	2	2444	1264	1180	42
22-12424508-C-T	0.083333	1	4	2038	1057	981	42
22-12424633-C-T	0.416667	5	10	2034	1058	976	24
22-12424870-C-T	0.333333	4	8	2014	1048	966	19
22-12425909-T-C	0.5	6	10	26622	13553	13069	58
22-12426514-C-A	0.083333	1	2	2034	1050	984	16
22-12426688-C-T	0.083333	1	2	743	384	359	48
22-12426729-A-G	0.333333	4	8	12	5	7	35
22-12426764-G-T	0.083333	1	4	2070	1075	995	29
22-12427234-C-T	0.083333	1	2	1989	1029	960	18
22-12427325-G-T	1	12	12	75908	38844	37064	55
22-12427406-T-C	0.083333	1	2	2299	1185	1114	14
22-12427862-T-G	0.166667	2	4	325	159	166	23
22-12427917-G-A	0.083333	1	2	614	314	300	39
22-12428484-T-C	0.583333	7	12	26670	13573	13097	49
22-12428535-G-A	0.083333	1	10	6	1	5	18
22-12428656-G-A	0.166667	2	10	35	21	14	14
22-12429685-C-G	0.5	6	12	2427	1254	1173	25
22-12430004-A-G	0.5	6	12	1849	947	902	15
22-12430111-T-C	0.416667	5	8	26688	13590	13098	44
22-12430372-T-C	0.166667	2	2	26531	13509	13022	46
22-12430785-A-AC	0.166667	2	6	26455	13493	12962	24
22-12431378-C-A	0.333333	4	6	26088	13271	12817	44
22-12431711-G-C	0.166667	2	4	1996	1034	962	31
22-12432081-CTG-C	0.166667	1	2	1908	986	922	15
22-12432178-T-G	0.25	3	4	26478	13486	12992	49
22-12432192-T-G	0.083333	1	10	311	151	160	37
22-12432207-C-CT	0.083333	1	8	310	152	158	36
22-12432208-C-T	0.083333	1	12	310	152	158	36
22-12432272-G-A	0.083333	1	2	2416	1250	1166	25
22-12432615-A-T	0.25	3	6	2016	1044	972	24
22-12432617-G-T	0.25	3	6	2016	1046	970	14
22-12432717-C-T	0.083333	1	2	323	157	166	26
22-12432766-G-A	0.166667	2	4	2038	1054	984	43
22-12432879-G-A	0.166667	2	8	31	17	14	13
22-12433068-G-C	0.333333	4	8	1911	993	918	37
22-12433204-T-C	0.166667	2	12	5	1	4	22
22-12433404-T-G	0.083333	1	2	919	459	460	28
22-12433631-G-T	0.333333	4	8	44	24	20	15
22-12433880-T-C	0.166667	2	2	26597	13553	13044	42
22-12433974-T-A	0.166667	2	2	26584	13548	13036	50
22-12434316-A-C	0.083333	1	2	2041	1056	985	18
22-12434437-T-C	0.333333	4	8	1136	593	543	33
22-12434689-T-C	0.083333	1	2	2489	1277	1212	22
22-12434761-G-T	0.166667	2	4	2073	1069	1004	18
22-12434877-T-C	0.416667	5	8	26675	13579	13096	56
22-12434918-C-T	0.083333	1	8	2086	1074	1012	33
22-12434927-G-T	0.083333	1	10	9	1	8	24
22-12434936-C-T	0.083333	1	6	2104	1084	1020	31
22-12434945-C-T	0.083333	1	10	8	1	7	28
22-12435163-A-T	0.083333	1	2	1848	965	883	22
22-12435297-T-A	0.583333	7	12	14	4	10	15
22-12435602-T-C	0.083333	1	2	2010	1027	983	35
22-12435624-A-T	0.083333	1	2	2026	1041	985	31
22-12435678-C-A	0.333333	4	12	0	0	0	10
22-12435702-T-A	0.083333	1	2	325	154	171	23
22-12436475-G-T	0.333333	4	12	0	0	0	12
22-12436677-A-G	0.083333	1	2	2385	1236	1149	13
22-12436873-T-TC	0.333333	4	8	58874	30203	28671	37
22-12437262-G-T	0.083333	1	10	6	1	5	18
22-12437436-T-A	0.5	6	10	26074	13243	12831	50
22-12438435-A-G	0.666667	7	12	26327	13412	12915	57
22-12438463-A-T	0.166667	2	12	12	2	10	21
22-12491641-A-G	0.333333	4	6	44810	22863	21947	19
22-12492622-A-G	0.333333	4	8	931	522	409	11
22-12493547-G-A	0.25	2	10	5	3	2	11
22-12497039-T-C	0.166667	2	12	1	1	0	10
22-12497792-T-C	1	12	12	70457	36304	34153	25
22-12499302-C-G	0.416667	5	8	44998	22937	22061	37
22-12502679-A-G	0.333333	4	4	48981	24967	24014	13
22-12503234-C-A	0.166667	2	6	41	23	18	12
22-12505523-A-G	0.416667	3	6	22810	11715	11095	41
22-12506533-T-C	0.333333	4	10	1616	779	837	20
22-12508557-G-A	0.416667	5	10	5046	2721	2325	33
22-12512621-T-A	0.25	3	12	547	266	281	28
22-12512628-T-G	0.25	3	12	530	252	278	32
22-12512692-A-G	0.25	3	12	389	199	190	14
22-12512958-G-A	1	12	12	47352	24304	23048	49
22-12513563-T-C	0.166667	2	6	11690	6553	5137	26
22-12517798-A-AT	0.166667	1	2	3710	1650	2060	14
22-12519622-G-A	0.25	3	6	86	41	45	14
22-12520370-T-C	0.083333	1	8	20217	10760	9457	12
22-12521661-C-A	0.083333	1	12	195	91	104	29
22-12522251-C-T	0.083333	1	12	73	30	43	28
22-12523167-A-T	0.166667	2	10	20571	10836	9735	12
22-12523414-G-T	0.25	3	12	64	31	33	10
22-12524091-G-A	0.333333	4	12	841	395	446	23
22-12528419-T-C	0.416667	5	10	161	72	89	11
22-12530336-C-T	0.25	3	12	2182	1150	1032	11
22-12532167-A-C	0.416667	5	6	25587	13775	11812	42
22-12533778-G-A	0.166667	2	12	137	70	67	13
22-12536559-GA-G	0.333333	4	6	22	14	8	17
22-12540194-A-G	0.75	9	12	1414	664	750	20
22-12547089-A-G	0.333333	4	10	1263	662	601	12
22-12547104-T-C	0.166667	2	2	2382	1215	1167	16
22-12548960-G-A	0.083333	1	6	12	6	6	21
22-12550469-T-G	0.416667	5	6	21134	11034	10100	43
22-12550579-G-C	0.166667	2	12	0	0	0	11
22-12556022-A-C	1	12	12	52534	27222	25312	28
22-12565859-G-GT	0.166667	2	10	479	246	233	10
22-12566003-G-T	0.333333	4	12	529	250	279	12
22-12567188-T-G	1	12	12	54664	28820	25844	43
22-12567885-G-A	0.166667	2	6	0	0	0	10
22-12568828-A-G	0.25	2	12	0	0	0	12
22-12569073-A-C	0.333333	4	8	16972	8405	8567	11
22-12569116-A-T	0.333333	4	8	36970	19050	17920	29
22-12569996-T-C	0.25	3	10	1294	618	676	10
22-12571100-G-GTAAA	0.083333	1	10	0	0	0	13
22-12571131-A-AGAAG	0.333333	4	6	399	222	177	28
22-12571215-G-GGGAAA	0.583333	7	12	1837	997	840	33
22-12571351-G-GAAGA	0.416667	5	8	1269	702	567	24
22-12571351-G-GAAGAAAGA	0.166667	2	8	1058	543	515	24
22-12574896-A-AAC	0.166667	2	8	18536	9920	8616	11
22-12576050-T-A	0.25	3	12	2462	1287	1175	15
22-12576902-T-C	0.166667	2	6	11248	6198	5050	16
22-12578780-T-A	0.25	3	12	787	408	379	20
22-12582521-TTA-T	0.5	6	8	2810	1510	1300	12
22-12584454-A-G	0.5	6	8	41597	21194	20403	32
22-12590164-A-C	1	12	12	69822	35610	34212	56
22-12592026-T-TA	0.5	6	12	4	1	3	15
22-12592853-A-C	0.166667	2	6	0	0	0	11
22-12593221-G-T	0.25	3	10	0	0	0	12
22-12593848-A-G	0.5	6	12	64	29	35	26
22-12595798-T-A	0.583333	5	8	35	19	16	13
22-12596019-G-C	0.5	6	12	0	0	0	14
22-12596184-T-C	0.666667	8	12	44244	22594	21650	55
22-12597338-A-G	0.416667	5	10	0	0	0	16
22-12598665-C-T	0.666667	8	12	41949	21347	20602	58
22-12598720-T-C	0.416667	5	10	19978	10511	9467	38
22-12599898-G-T	0.25	3	6	851	403	448	16
22-12600082-G-A	0.333333	4	8	1454	735	719	11
22-12601253-T-C	0.333333	4	8	81	39	42	15
22-12601612-T-A	0.416667	5	10	78	37	41	14
22-12602030-T-C	0.333333	4	8	20826	10937	9889	20
22-12602055-A-C	0.166667	2	6	81	42	39	12
22-12602090-G-A	0.25	3	6	64	30	34	11
22-12602160-A-C	0.5	6	12	66	37	29	27
22-12602177-TGG-T	0.5	6	12	62	33	29	26
22-12602430-A-G	0.25	3	6	76	38	38	19
22-12602521-C-T	0.416667	5	10	63	31	32	25
22-12602585-G-C	0.5	6	12	350	170	180	43
22-12605984-C-T	0.333333	4	8	0	0	0	12
22-12608343-T-TTTGA	0.166667	2	10	184	101	83	10
22-12608604-A-G	0.083333	1	6	78	38	40	11
22-12608642-A-G	0.083333	1	4	8130	4291	3839	10
22-12609069-A-G	0.5	6	12	70	33	37	16
22-12609402-G-A	0.5	6	12	46	23	23	12
22-12609711-G-A	0.666667	8	12	44228	22584	21644	52
22-12610835-G-C	0.416667	5	10	9	6	3	11
22-12611587-C-A	0.416667	5	10	91	44	47	18
22-12612894-A-G	0.5	6	8	41930	21344	20586	51
22-12613439-A-G	0.416667	5	10	77	37	40	25
22-12614336-A-C	0.5	6	12	70	31	39	11
22-12614723-T-G	0.166667	2	8	0	0	0	12
22-12614748-CA-C	0.333333	4	8	67	31	36	34
22-12614873-T-C	0.25	3	6	72	36	36	10
22-12615323-T-TAA	0.166667	2	4	8294	4377	3917	10
22-12617725-CT-C	0.416667	5	8	51	27	24	11
22-12617725-C-CT	0.083333	1	8	23	9	14	11
22-12618034-C-A	0.333333	4	8	72	34	38	16
22-12620461-G-T	0.166667	2	12	21	10	11	42
22-12620575-C-T	0.416667	5	10	75	35	40	34
22-12620843-G-A	0.333333	4	6	32306	16648	15658	26
22-12621761-G-T	0.5	6	12	0	0	0	22
22-12623162-T-G	0.166667	2	4	7	3	4	15
22-12623342-G-A	0.5	6	12	10	5	5	20
22-12624902-CT-C	0.25	3	10	0	0	0	13
22-12625009-G-C	0.416667	5	10	20014	10535	9479	17
22-12627164-C-A	0.25	3	10	0	0	0	14
22-12629197-A-G	0.166667	2	12	0	0	0	15
22-12629528-A-T	0.416667	5	10	10	6	4	11
22-12629588-GAAAAAAAAA-G	0.25	3	12	0	0	0	23
22-12629588-GAAA-G	0.25	3	12	85	40	45	23
22-12629588-GA-G	0.166667	2	12	28	15	13	23
22-12629588-GAA-G	0.083333	1	12	463	249	214	23
22-12630004-C-T	0.5	6	12	33	12	21	36
22-12632614-T-C	0.25	3	6	28	9	19	25
22-12633872-A-C	1	12	12	71502	36555	34947	66
22-12634091-C-T	0.416667	5	10	15	7	8	16
22-12635555-TA-T	0.416667	5	12	1498	777	721	11
22-12635568-C-CAGTT	0.166667	2	6	31	12	19	10
22-12637618-A-AAGAGGGAAGGAAGGAG	0.333333	4	9	10573	5482	5091	25
22-12637805-AGAGGGAAGGAAG-A	0.25	3	8	3	0	3	10
22-12638407-A-AT	0.416667	5	10	0	0	0	18
22-12639145-T-C	0.333333	4	8	20016	10536	9480	22
22-12641395-C-G	0.5	6	12	67	34	33	10
22-12691827-T-A	0.083333	1	6	26	18	8	13
22-12691954-G-C	0.166667	2	6	8020	4172	3848	18
22-12691965-G-A	0.416667	5	12	3559	1779	1780	26
22-12692061-G-A	0.416667	5	10	11058	5637	5421	14
22-12692351-C-A	0.25	3	10	271	129	142	22
22-12692595-C-A	0.333333	4	8	9	5	4	25
22-12692722-T-C	0.166667	2	6	1	1	0	24
22-12692756-G-A	0.333333	4	10	0	0	0	40
22-12692772-C-T	0.333333	4	12	5486	2817	2669	35
22-12692776-A-C	0.333333	4	10	11	6	5	31
22-12692784-T-C	0.583333	7	12	32795	16642	16153	61
22-12692810-C-T	0.25	3	10	99	51	48	14
22-12692818-A-G	0.166667	2	8	8845	4524	4321	15
22-12692859-AG-A	0.083333	1	4	101	49	52	10
22-12692877-G-A	0.166667	2	6	102	46	56	14
22-12692898-T-C	0.083333	1	4	139	73	66	20
22-12692916-G-A	0.166667	2	6	188	102	86	11
22-12692927-G-C	0.166667	2	6	173	89	84	11
22-12692938-T-C	0.166667	2	8	8381	4297	4084	17
22-12692948-G-A	0.25	3	10	411	216	195	27
22-12692949-T-C	0.25	3	8	1026	527	499	25
22-12692956-A-G	0.25	3	10	2741	1427	1314	29
22-12692974-T-C	0.25	3	8	4813	2474	2339	34
22-12693001-G-T	0.083333	1	10	0	0	0	16
22-12693002-C-T	0.083333	1	10	0	0	0	16
22-12693017-T-G	0.333333	4	12	3162	1678	1484	28
22-12693061-T-C	0.333333	4	10	4383	2339	2044	36
22-12693076-A-T	0.416667	5	12	4541	2408	2133	38
22-12693080-C-G	0.416667	5	12	5054	2711	2343	37
22-12693094-G-A	0.583333	7	12	32980	17068	15912	46
22-12693095-T-C	0.416667	5	12	5044	2717	2327	35
22-12693120-G-A	0.416667	5	12	6707	3581	3126	39
22-12693134-C-CA	0.416667	5	12	6885	3648	3237	55
22-12693134-C-CG	0.166667	2	12	2309	1159	1150	55
22-12693176-G-A	0.333333	4	10	7622	3992	3630	53
22-12693183-G-C	0.083333	1	12	13	7	6	40
22-12693186-T-C	0.583333	7	12	44354	22656	21698	60
22-12693215-G-T	0.333333	4	10	8106	4236	3870	49
22-12693256-T-C	0.583333	7	12	38577	19690	18887	67
22-12693277-A-G	0.333333	4	12	8082	4222	3860	44
22-12693286-C-A	0.333333	4	12	7209	3778	3431	44
22-12693348-C-G	0.333333	4	10	5824	3078	2746	30
22-12693371-T-C	0.333333	4	12	5334	2805	2529	47
22-12693373-G-A	0.25	3	12	916	436	480	59
22-12693411-G-A	0.25	3	12	59	25	34	54
22-12693422-A-G	0.416667	5	12	991	509	482	37
22-12693712-T-C	0.333333	4	12	2957	1589	1368	42
22-12693845-C-T	0.333333	4	12	0	0	0	32
22-12693956-A-G	0.333333	4	12	20454	10251	10203	37
22-12693973-G-T	0.333333	4	12	1	0	1	51
22-12694166-T-A	0.333333	4	12	43557	22268	21289	52
22-12695534-A-G	0.166667	2	6	38559	19389	19170	24
22-12695801-G-T	0.166667	2	4	9509	4840	4669	16
22-12697011-A-G	0.166667	2	2	115	60	55	18
22-12697117-T-C	0.5	6	10	8077	4004	4073	39
22-12697677-T-C	0.166667	2	10	48737	24750	23987	37
22-12697772-A-T	1	12	12	74603	38195	36408	52
22-12697791-A-T	0.166667	2	2	51828	26353	25475	36
22-12698163-T-C	0.25	3	6	47507	24115	23392	49
22-12698236-A-G	0.166667	2	6	40700	20531	20169	47
22-12698350-A-G	0.416667	5	8	40977	20669	20308	44
22-12698677-C-A	0.166667	2	8	8054	4260	3794	32
22-12699118-A-G	0.166667	2	8	36486	18359	18127	36
22-12700055-GC-G	0.166667	2	4	5	2	3	10
22-12700342-T-A	0.333333	4	8	30	17	13	17
22-12700644-C-A	0.333333	4	6	41970	21227	20743	47
22-12700823-C-T	0.25	3	4	38605	19427	19178	41
22-12701185-T-C	0.166667	2	6	38564	19397	19167	41
22-12701491-T-A	0.416667	5	8	47425	24086	23339	40
22-12701645-C-T	1	12	12	74537	38171	36366	47
22-12702801-G-A	0.166667	2	4	5580	2768	2812	11
22-12703595-A-G	0.25	3	4	48080	24424	23656	41
22-12704212-G-T	0.166667	2	2	26	11	15	14
22-12704299-A-G	0.333333	4	8	9941	5058	4883	12
22-12704446-A-G	0.166667	2	2	38665	19467	19198	31
22-12704864-TAC-T	0.166667	2	4	0	0	0	23
22-12705122-T-A	0.333333	4	10	0	0	0	22
22-12705199-G-T	0.083333	1	12	0	0	0	11
22-12705698-G-T	0.083333	1	2	11124	5628	5496	17
22-12705704-CAAA-C	0.166667	2	4	27	13	14	11
22-12705704-C-CA	0.083333	1	4	339	181	158	11
22-12705733-A-AG	1	12	12	71506	36747	34759	32
22-12706063-G-T	0.333333	4	12	0	0	0	15
22-12706723-G-A	0.083333	1	10	0	0	0	17
22-12707042-T-C	0.333333	4	12	186	80	106	30
22-12707456-C-T	0.166667	2	8	47512	24125	23387	31
22-12707863-G-C	0.166667	2	2	41047	20726	20321	42
22-12708683-G-C	0.166667	2	10	47717	24253	23464	30
22-12709705-A-G	0.5	6	10	47481	24181	23300	28
22-12709709-C-T	0.333333	4	10	0	0	0	10
22-12709796-A-G	0.25	3	6	5379	2790	2589	18
22-12711543-C-G	0.25	3	6	13913	7326	6587	32
22-12712338-G-A	0.333333	4	12	14458	7217	7241	25
22-12712549-C-T	0.333333	4	12	3974	1907	2067	25
22-12712590-C-CAA	0.25	4	8	6120	3377	2743	21
22-12712626-T-C	0.083333	1	12	180	88	92	20
22-12712865-G-C	0.083333	1	12	0	0	0	17
22-12712883-G-C	0.333333	4	12	9	4	5	16
22-12712951-G-T	0.333333	4	8	39043	19840	19203	48
22-12712999-G-C	0.083333	1	12	12	4	8	34
22-12713007-A-ATATG	0.333333	4	8	8108	4234	3874	12
22-12713020-AACACACACACAC-A	0.333333	4	12	21	10	11	23
22-12713149-G-C	0.333333	4	12	194	94	100	28
22-12713189-C-T	0.333333	4	12	84	46	38	28
22-12713374-A-G	0.083333	1	8	2990	1643	1347	13
22-12713801-T-C	0.166667	2	4	30765	15954	14811	20
22-12713806-C-T	0.166667	2	8	11995	5974	6021	17
22-12713977-C-A	0.333333	4	12	25531	12952	12579	25
22-12714209-C-T	0.333333	4	12	15046	7913	7133	40
22-12716040-C-T	0.333333	4	6	26061	13526	12535	39
22-12716111-C-T	0.25	3	12	433	213	220	15
22-12716401-T-A	0.25	3	10	16	3	13	20
22-12716856-A-G	0.166667	2	8	22525	12039	10486	37
22-12716894-G-A	0.25	3	10	2671	1337	1334	27
22-12717033-T-C	0.166667	2	4	8506	4613	3893	18
22-12717415-T-C	0.166667	2	8	23	11	12	14
22-12718711-A-G	0.25	3	4	33146	16826	16320	36
22-12719111-C-G	0.25	3	10	22632	11865	10767	38
22-12719950-C-T	0.083333	1	12	483	283	200	29
22-12720101-T-C	0.333333	4	12	22796	12005	10791	33
22-12720104-T-C	0.25	3	12	14632	7687	6945	29
22-12720214-G-T	0.083333	1	12	313	188	125	25
22-12720430-G-A	0.333333	4	12	7872	4022	3850	23
22-12720860-C-T	0.25	3	10	125	59	66	28
22-12721517-A-C	0.166667	2	8	0	0	0	12
22-12721640-G-A	0.25	3	10	16986	8589	8397	21
22-12722442-A-G	0.083333	1	8	7255	3780	3475	12
22-12722820-C-T	0.416667	5	8	39423	19998	19425	43
22-12723021-G-A	0.083333	1	8	2	2	0	17
22-12723137-A-C	0.166667	2	12	17	9	8	31
22-12723173-A-G	0.333333	4	10	30400	15934	14466	33
22-12723237-G-A	0.166667	2	12	436	216	220	20
22-12724054-A-G	0.166667	2	10	1769	992	777	22
22-12724275-G-A	0.416667	5	10	28711	14959	13752	38
22-12724289-G-A	1	12	12	59650	31067	28583	57
22-12724574-G-A	0.25	3	4	16796	9093	7703	32
22-12724757-G-A	0.25	3	12	47	23	24	10
22-12724930-C-T	0.25	3	12	118	59	59	24
22-12725122-A-C	0.166667	2	10	3364	1708	1656	32
22-12725964-A-G	0.166667	2	2	24074	12841	11233	21
22-12725997-T-C	0.25	3	4	10515	5758	4757	13
22-12726182-A-G	0.666667	7	12	1	0	1	25
22-12776385-G-A	0.333333	4	12	11583	5800	5783	24
22-12776484-C-T	0.333333	4	12	19722	9997	9725	37
22-12777069-A-C	0.166667	2	10	983	522	461	24
22-12777098-C-G	0.166667	2	8	375	211	164	24
22-12777421-T-C	0.333333	4	12	13328	6812	6516	37
22-12777859-C-T	0.583333	6	12	1354	723	631	48
22-12777953-T-C	0.25	3	10	12711	6814	5897	36
22-12778188-C-A	0.333333	4	12	380	189	191	27
22-12778621-T-C	0.333333	4	12	26176	13357	12819	39
22-12778934-A-C	0.25	3	10	19298	10081	9217	41
22-12778967-G-T	0.25	3	10	20155	10477	9678	37
22-12779007-C-T	0.166667	2	8	21346	11030	10316	25
22-12779027-G-C	0.166667	2	8	22776	11732	11044	18
22-12779566-A-G	0.333333	4	12	35633	18431	17202	52
22-12779913-C-T	0.333333	4	12	17211	8818	8393	57
22-12779944-A-G	0.333333	4	12	16549	8492	8057	49
22-12780644-G-A	0.25	3	10	15140	7813	7327	17
22-12781242-T-C	0.333333	4	12	15081	7962	7119	32
22-12781274-A-G	0.166667	2	12	0	0	0	48
22-12781733-T-G	0.333333	4	12	3926	1836	2090	38
22-12782301-C-T	0.25	3	10	1	0	1	11
22-12782721-G-A	0.083333	1	12	506	248	258	16
22-12782762-T-G	0.25	3	10	23178	12176	11002	30
22-12783604-A-G	0.333333	4	10	20366	10714	9652	37
22-12783806-A-G	0.25	3	10	21474	11120	10354	48
22-12783834-C-T	0.333333	4	12	33005	17204	15801	26
22-12783858-G-A	0.583333	7	12	1795	980	815	32
22-12783955-T-C	0.25	3	10	27418	14063	13355	40
22-12784551-G-C	0.333333	4	12	4650	2084	2566	26
22-12784922-T-C	0.333333	4	12	19182	10050	9132	40
22-12785761-G-C	0.333333	4	12	13636	7132	6504	22
22-12785853-G-A	0.333333	4	12	15733	8160	7573	26
22-12786104-A-G	0.166667	2	8	7167	3783	3384	23
22-12786431-T-C	0.333333	4	12	16330	8600	7730	50
22-12786506-A-AAC	0.166667	1	10	777	437	340	25
22-12786506-A-AACACACACACAC	0.083333	1	10	57	32	25	25
22-12786901-T-G	0.333333	4	12	20118	10171	9947	31
22-12787344-A-AT	0.166667	2	10	5529	2935	2594	16
22-12787353-C-CT	0.166667	2	12	10437	5638	4799	29
22-12787625-G-A	0.333333	4	12	24095	12324	11771	38
22-12787633-A-C	0.166667	2	12	1708	925	783	14
22-12787818-C-T	0.333333	4	12	15329	8088	7241	57
22-12788071-T-G	0.25	3	10	18615	9753	8862	29
22-12788215-G-GA	1	12	12	49455	26071	23384	45
22-12788444-G-C	0.166667	2	10	2425	1390	1035	35
22-12788457-C-T	0.25	3	10	2998	1702	1296	37
22-12788478-G-C	0.25	3	10	2920	1584	1336	26
22-12789204-A-G	0.333333	4	12	16520	8642	7878	49
22-12789374-A-T	0.083333	1	12	4169	2173	1996	17
22-12789695-C-T	0.333333	4	12	27159	14227	12932	42
22-12789806-C-CAA	0.166667	2	7	2527	1490	1037	11
22-12789862-C-T	0.333333	4	12	10819	5993	4826	41
22-12789911-C-T	0.333333	4	12	11525	6310	5215	30
22-12789993-A-G	0.333333	4	12	21161	11072	10089	34
22-12790005-G-A	0.583333	7	12	1786	973	813	61
22-12790041-C-T	0.166667	2	12	0	0	0	29
22-12790092-C-T	0.333333	4	12	20587	10802	9785	32
22-12790111-A-G	0.333333	4	12	19419	10304	9115	44
22-12790562-T-C	0.166667	2	8	7815	4148	3667	39
22-12790851-A-G	0.166667	2	8	6766	3579	3187	27
22-12790925-A-G	0.25	3	10	790	372	418	17
22-12791158-C-T	0.166667	2	8	133	64	69	16
22-12791465-G-A	1	12	12	24116	12961	11155	45
22-12791513-A-G	0.25	3	10	6960	3758	3202	30
22-12791528-C-T	0.25	3	10	8138	4254	3884	15
22-12791538-A-T	0.25	3	10	9339	4823	4516	15
22-12792675-G-T	0.25	3	6	8481	4491	3990	32
22-12792800-T-C	0.333333	4	12	6772	3365	3407	37
22-12793481-G-A	0.333333	4	12	9402	4580	4822	47
22-12793620-C-T	0.25	3	8	15035	7474	7561	19
22-12793701-T-C	0.25	3	10	14020	7089	6931	35
22-12793778-C-G	0.333333	4	12	20012	10224	9788	40
22-12794103-T-A	0.333333	4	12	599	269	330	14
22-12795714-G-A	0.333333	4	12	25791	13127	12664	58
22-12797464-A-G	0.333333	4	8	27008	13712	13296	47
22-12797511-A-C	0.333333	4	12	1658	806	852	38
22-12798122-A-G	0.25	3	12	18722	9883	8839	48
22-12798242-G-A	0.333333	4	10	18279	9507	8772	48
22-12798349-T-G	0.25	3	8	22307	11817	10490	42
22-12798364-T-C	0.166667	2	8	21586	11357	10229	40
22-12798445-C-G	0.333333	4	8	21083	10833	10250	39
22-12798501-C-A	0.25	3	12	27663	14514	13149	56
22-12799120-T-A	0.333333	4	12	3150	1605	1545	34
22-12799145-C-T	0.333333	4	12	3690	1868	1822	32
22-12799246-G-A	0.333333	4	12	17552	8840	8712	50
22-12799247-T-G	0.333333	4	12	33134	17052	16082	50
22-12799469-G-A	0.333333	4	12	4196	2027	2169	43
22-12799628-A-G	0.25	3	10	20340	10815	9525	39
22-12799750-A-G	0.333333	4	12	33440	17169	16271	45
22-12799761-T-C	0.333333	4	12	33271	17081	16190	34
22-12801029-C-A	0.166667	2	8	402	177	225	13
22-12801573-A-T	0.083333	1	8	92	46	46	12
22-12801747-C-A	0.333333	4	12	3453	1684	1769	23
22-12801772-G-C	0.333333	4	12	3508	1666	1842	26
22-12801805-G-T	0.333333	4	12	3469	1654	1815	31
22-12801932-G-T	0.083333	1	12	0	0	0	12
22-12802047-A-G	0.333333	4	12	37012	19091	17921	48
22-12802059-T-G	0.333333	4	12	36978	19074	17904	50
22-12802252-T-C	0.333333	4	12	33958	17663	16295	51
22-12802384-G-A	0.833333	10	10	26097	13946	12151	58
22-12802457-A-C	0.25	3	10	5193	2883	2310	55
22-12802501-C-T	0.25	3	12	3119	1763	1356	36
22-12802508-T-C	0.166667	2	12	2553	1437	1116	40
22-12803153-T-A	0.333333	4	12	7745	3780	3965	47
22-12803353-C-G	0.5	6	12	24247	12667	11580	37
22-12803453-T-A	0.333333	4	12	10503	5275	5228	41
22-12803914-A-G	0.083333	1	10	3459	1838	1621	38
22-12804032-T-C	0.25	3	12	10303	5393	4910	47
22-12804054-T-C	0.166667	2	12	822	457	365	18
22-12804173-C-G	0.333333	4	12	22756	11721	11035	48
22-12804218-A-C	0.333333	4	12	22620	11738	10882	44
22-12804243-G-C	0.166667	2	12	3	3	0	26
22-12804349-C-T	0.25	3	10	5822	2885	2937	41
22-12804652-G-T	0.333333	4	12	384	177	207	42
22-12804814-T-G	0.166667	2	10	10094	5448	4646	21
22-12805166-G-A	0.25	3	10	1131	527	604	37
22-12805658-T-C	0.25	3	10	359	169	190	10
22-12806215-G-A	0.333333	4	12	29518	15456	14062	49
22-12806686-G-C	0.083333	1	12	54	25	29	32
22-12806763-A-C	0.333333	4	12	33586	17556	16030	37
22-12806784-C-A	0.333333	4	12	23443	12098	11345	49
22-12806990-G-C	0.166667	2	12	289	182	107	26
22-12807019-T-A	0.416667	5	10	34259	17857	16402	36
22-12807023-C-T	0.333333	4	12	16039	8178	7861	33
22-12807056-G-A	0.166667	2	10	5	3	2	14
22-12807090-G-T	0.166667	2	10	2027	1042	985	16
22-12807238-A-T	0.166667	2	10	992	546	446	20
22-12807327-G-GA	0.333333	4	12	2026	1109	917	26
22-12807336-G-T	0.333333	4	12	2996	1645	1351	18
22-12807455-T-TATAATAATAATA	0.166667	2	10	19	13	6	15
22-12807455-T-TATAATAATAATAATAATA	0.166667	2	10	746	404	342	15
22-12807531-C-CA	0.166667	2	10	628	328	300	23
22-12807531-CA-C	0.083333	1	10	435	224	211	23
22-12807549-CA-C	0.333333	4	12	3721	1897	1824	32
22-12807600-T-G	0.166667	2	4	27767	14289	13478	44
22-12808568-G-T	0.25	3	10	3259	1557	1702	30
22-12808750-A-C	0.333333	4	12	26228	13543	12685	45
22-12808865-T-G	0.833333	10	10	30630	16241	14389	53
22-12809030-G-A	0.333333	4	12	18046	9307	8739	42
22-12809039-G-C	0.333333	4	12	17275	8930	8345	39
22-12809375-T-C	0.166667	2	10	423	224	199	17
22-12809879-C-A	0.333333	4	12	24186	12372	11814	17
22-12810063-G-T	0.333333	4	12	21561	11076	10485	30
22-12810072-A-C	0.083333	1	12	319	155	164	39
22-12810173-T-C	1	12	12	47551	24963	22588	50
22-12810510-T-C	0.333333	4	12	4214	2117	2097	52
22-12810824-G-A	0.333333	4	8	15823	8035	7788	39
22-12810922-G-GGTAA	0.333333	4	12	26665	13752	12913	47
22-12811073-T-C	0.833333	10	12	38225	20155	18070	27
22-12811074-G-A	0.833333	9	12	37846	19951	17895	23
22-12811235-A-C	0.25	3	10	13305	7152	6153	26
22-12811277-A-G	0.916667	11	12	23611	12749	10862	44
22-12811426-G-T	0.083333	1	12	323	151	172	42
22-12811583-G-T	0.333333	4	12	3969	1991	1978	37
22-12811824-A-G	0.333333	4	12	6267	3154	3113	33
22-12811880-A-G	0.25	3	10	6867	3472	3395	34
22-12812135-C-T	0.333333	4	8	12389	6818	5571	30
22-12812480-C-G	0.333333	4	12	8	2	6	25
22-12812538-G-A	0.083333	1	12	0	0	0	12
22-12812594-G-A	0.333333	4	8	2	2	0	17
22-12812951-G-C	0.166667	2	6	19206	10331	8875	33
22-12813125-T-C	0.25	3	12	6228	3456	2772	40
22-12813193-G-A	0.166667	2	10	8775	4668	4107	14
22-12813223-C-A	0.25	3	10	3994	2119	1875	23
22-12813444-G-A	0.25	3	10	15594	8073	7521	41
22-12813942-G-T	0.25	3	10	13849	7263	6586	33
22-12814021-A-C	0.166667	2	12	2377	1314	1063	34
22-12814029-C-T	0.166667	2	12	2090	1156	934	17
22-12814121-C-G	0.833333	10	10	32334	17046	15288	56
22-12814329-A-C	1	12	12	11813	6408	5405	39
22-12815152-T-A	0.333333	4	12	7311	3632	3679	29
22-12815317-T-C	0.083333	1	6	2183	1167	1016	11
22-12815548-C-A	0.333333	4	12	36178	18701	17477	51
22-12815583-G-C	0.333333	4	10	36789	18993	17796	38
22-12815613-C-T	0.333333	4	12	24391	12385	12006	27
22-12815786-A-G	0.333333	4	12	37100	19101	17999	55
22-12816124-CT-C	0.333333	4	12	17906	9258	8648	42
22-12816539-T-C	0.25	3	10	12482	6318	6164	26
22-12816695-C-T	0.166667	2	12	524	276	248	15
22-12816820-T-C	0.166667	2	12	35	17	18	35
22-12817273-T-C	0.166667	2	8	32532	16992	15540	27
22-12817297-C-A	0.333333	4	12	15724	7966	7758	26
22-12817353-T-A	0.333333	4	12	25657	13098	12559	39
22-12817657-G-C	0.333333	4	12	185	74	111	20
22-12818022-C-G	0.166667	2	8	203	112	91	26
22-12874211-T-C	0.333333	4	4	1401	736	665	14
22-12881022-C-G	0.416667	5	12	2486	1255	1231	22
22-12887666-A-C	0.166667	2	2	0	0	0	18
22-12892278-G-A	0.166667	2	10	574	296	278	12
22-12900639-G-A	0.166667	2	8	0	0	0	11
22-12903116-C-G	0.333333	4	10	3	2	1	14
22-12903154-A-T	0.5	6	10	4	2	2	14
22-12903306-A-T	0.666667	8	12	230	113	117	13
22-12903360-T-TA	0.166667	2	8	53	31	22	21
22-12903365-G-A	0.166667	2	8	80	48	32	20
22-12903388-T-A	0.416667	5	10	5788	3056	2732	32
22-12903574-T-C	0.833333	10	12	2576	1334	1242	19
22-12903663-T-A	0.833333	10	12	3086	1634	1452	22
22-12903670-C-T	0.833333	10	12	2338	1234	1104	20
22-12904374-C-T	0.166667	2	4	0	0	0	18
22-12904376-G-T	0.166667	2	6	0	0	0	17
22-15154524-C-A	0.083333	1	12	15	12	3	13
22-15156650-C-G	0.333333	4	8	0	0	0	16
22-15160310-T-C	0.333333	4	4	0	0	0	20
22-15161534-G-A	0.5	6	10	22570	11550	11020	22
22-15161548-G-A	0.333333	4	6	20870	10657	10213	20
22-15162060-A-G	0.166667	2	10	0	0	0	13
22-15162442-G-A	0.583333	7	12	5468	2960	2508	16
22-15163199-G-C	1	12	12	71915	36935	34980	39
22-15163632-G-A	0.333333	4	8	0	0	0	12
22-15164033-A-G	0.333333	4	6	3406	1785	1621	14
22-15165712-T-C	0.583333	7	12	457	249	208	22
22-15165781-A-T	1	12	12	19776	11037	8739	38
22-15165801-T-C	1	12	12	23672	13066	10606	45
22-15165833-C-T	0.583333	7	12	3141	1766	1375	23
22-15166469-A-T	1	12	12	71671	36746	34925	55
22-15166675-C-T	1	12	12	71718	36770	34948	65
22-15166759-C-T	0.25	3	12	693	350	343	51
22-15167053-C-T	0.833333	10	12	22241	11497	10744	61
22-15167127-A-C	1	12	12	74815	38351	36464	55
22-15167174-A-T	0.25	3	12	565	283	282	30
22-15167186-C-T	0.25	3	12	538	264	274	27
22-15167226-T-C	1	12	12	62682	32730	29952	59
22-15167331-T-C	1	12	12	35855	19665	16190	58
22-15167509-G-A	0.333333	4	10	202	116	86	16
22-15167756-T-C	1	12	12	50370	26479	23891	41
22-15167843-G-A	1	12	12	20213	10636	9577	41
22-15168713-C-T	0.75	9	12	2423	1333	1090	21
22-15169116-G-C	0.75	9	12	8719	4692	4027	20
22-15169272-C-T	0.166667	2	8	0	0	0	10
22-15170866-G-C	0.666667	8	10	141	73	68	20
22-15171024-A-C	0.166667	2	6	0	0	0	15
22-15173543-T-C	0.5	6	10	0	0	0	12
22-15174834-T-G	0.833333	10	10	44	20	24	16
22-15175932-T-C	0.75	9	12	6453	3484	2969	37
22-15176212-G-A	0.166667	2	10	2610	1319	1291	16
22-15176924-C-G	0.333333	4	6	0	0	0	11
22-15177526-T-A	1	12	12	12023	6016	6007	20
22-15177706-C-G	1	12	12	691	346	345	20
22-15177732-C-T	0.833333	10	10	199	94	105	24
22-15177733-A-G	0.833333	10	10	170	81	89	26
22-15177741-T-C	0.833333	10	12	80	42	38	24
22-15181229-A-G	0.166667	1	2	0	0	0	11
22-15181724-G-A	0.666667	8	10	2	1	1	10
22-15182268-C-CTG	0.333333	4	12	0	0	0	15
22-15182528-C-A	0.333333	4	8	4	3	1	12
22-15182988-G-C	0.75	9	10	183	86	97	22
22-15183190-C-A	1	12	12	37534	20177	17357	24
22-15183208-G-A	0.5	6	12	1282	654	628	15
22-15185940-G-A	0.166667	2	12	0	0	0	10
22-15190359-A-C	1	12	12	55412	29043	26369	24
22-15192925-A-G	0.666667	8	10	0	0	0	13
22-15193842-T-G	1	12	12	0	0	0	21
22-15193883-A-G	0.083333	1	12	0	0	0	10
22-15194315-C-T	1	12	12	39	9	30	34
22-15194366-A-AG	0.333333	4	8	5	2	3	16
22-15194400-T-C	0.833333	10	10	3	0	3	19
22-15194826-T-C	0.833333	10	10	209	101	108	12
22-15194900-T-A	0.916667	11	12	486	221	265	18
22-15195055-A-T	1	12	12	17869	9029	8840	25
22-15195152-T-G	1	12	12	59494	30744	28750	40
22-15195222-G-C	0.833333	10	12	6821	3198	3623	11
22-15195338-G-A	0.75	9	12	588	278	310	13
22-15198629-T-A	1	12	12	36627	19819	16808	33
22-15199611-C-T	1	12	12	701	357	344	15
22-15199618-T-C	1	12	12	768	392	376	14
22-15199659-A-G	0.5	6	6	696	379	317	13
22-15199792-A-T	0.5	6	8	0	0	0	13
22-15199830-C-A	0.833333	10	10	321	147	174	25
22-15199843-C-T	0.833333	10	10	535	259	276	15
22-15199873-A-T	0.833333	10	10	796	392	404	16
22-15200042-T-A	0.666667	8	10	1885	986	899	20
22-15200116-A-C	1	12	12	169	82	87	25
22-15200372-T-C	0.166667	2	12	0	0	0	10
22-15200373-T-A	0.166667	2	10	0	0	0	10
22-15200444-C-T	0.666667	8	10	9	4	5	26
22-15202157-A-C	0.833333	10	10	2091	1063	1028	23
22-15202254-T-C	1	12	12	69175	35652	33523	28
22-15202642-G-A	1	12	12	50368	26761	23607	34
22-15203133-T-C	0.166667	2	8	1	0	1	15
22-15203183-C-T	0.416667	5	10	0	0	0	11
22-15203778-C-T	0.333333	4	10	0	0	0	16
22-15203857-A-C	0.833333	10	10	0	0	0	14
22-15203904-T-C	0.166667	2	6	2	2	0	14
22-15204812-G-A	0.166667	2	12	4	0	4	31
22-15205048-T-TAATA	0.333333	4	10	3026	1633	1393	15
22-15205370-A-G	0.5	6	12	49	23	26	22
22-15208486-G-A	1	12	12	72	35	37	23
22-15208763-G-A	0.666667	8	10	12964	6458	6506	31
22-15209282-A-G	1	12	12	71466	36671	34795	50
22-15209497-A-G	1	12	12	73	31	42	38
22-15209669-G-A	0.5	6	6	58	26	32	14
22-15209975-G-A	0.833333	10	12	2	1	1	15
22-15212138-A-G	0.333333	4	12	1005	520	485	15
22-15213090-A-G	0.833333	10	10	1781	1005	776	19
22-15213146-G-T	1	12	12	19949	10954	8995	25
22-15213169-C-G	1	12	12	16101	8921	7180	26
22-15213224-T-C	0.833333	10	10	1636	903	733	24
22-15213280-A-G	0.416667	4	6	55	25	30	10
22-15213487-C-T	0.833333	10	10	4727	2610	2117	25
22-15213510-T-C	0.833333	10	10	1746	933	813	19
22-15213524-C-A	0.833333	10	10	26	14	12	17
22-15214583-G-A	0.666667	8	10	179	96	83	13
22-15214620-T-A	0.666667	8	8	1493	810	683	17
22-15216177-A-T	0.166667	1	4	0	0	0	10
22-15216689-G-A	0.916667	11	12	0	0	0	26
22-15219434-G-A	0.333333	4	8	0	0	0	12
22-15219444-G-A	0.166667	2	10	0	0	0	10
22-15219556-AAGTTT-A	0.916667	11	12	0	0	0	16
22-15219648-A-G	0.833333	10	10	1889	961	928	27
22-15219651-A-G	1	12	12	2370	1189	1181	25
22-15219762-C-A	0.75	9	12	223	117	106	23
22-15219776-C-G	0.833333	10	10	131	67	64	14
22-15219789-T-C	0.833333	10	10	44	26	18	12
22-15219891-T-A	0.5	6	8	10	2	8	12
22-15219894-C-A	0.333333	4	6	11	2	9	21
22-15219902-G-A	0.333333	4	4	8	1	7	18
22-15220411-C-T	0.166667	1	12	0	0	0	10
22-15220415-A-T	0.333333	4	10	2376	1230	1146	21
22-15220415-A-C	0.333333	4	10	250	119	131	21
22-15220500-C-G	0.25	3	12	185	102	83	13
22-15220631-G-A	0.5	6	12	2820	1511	1309	15
22-15220670-C-A	0.416667	5	8	1295	693	602	25
22-15220671-A-G	1	12	12	35421	18815	16606	39
22-15221020-G-A	1	12	12	52202	27274	24928	41
22-15222415-G-C	0.25	3	4	26	15	11	10
22-15222580-T-C	1	12	12	39907	21609	18298	30
22-15223643-C-T	0.833333	10	10	0	0	0	12
22-15224065-G-A	0.75	9	12	19703	10221	9482	31
22-15224274-G-C	0.666667	8	10	6607	3682	2925	34
22-15224979-G-A	0.333333	4	6	171	91	80	15
22-15225095-A-G	0.166667	2	4	2	2	0	13
22-15225921-G-T	0.333333	4	10	0	0	0	19
22-15227590-T-C	0.166667	2	10	9	4	5	18
22-15229463-C-CT	1	12	12	29749	15845	13904	24
22-15229763-T-TC	0.416667	5	6	0	0	0	22
22-15229992-C-T	0.25	3	12	1321	694	627	19
22-15230067-T-G	0.333333	4	6	218	137	81	27
22-15230193-A-G	0.166667	2	12	0	0	0	10
22-15231846-A-AGT	0.416667	5	8	1075	598	477	17
22-15233036-G-A	0.166667	2	2	1	1	0	10
22-15233053-T-C	0.333333	4	10	0	0	0	15
22-15233382-C-T	0.666667	8	8	0	0	0	17
22-15233566-T-C	0.333333	4	8	0	0	0	16
22-15233827-G-T	0.166667	2	6	2	1	1	18
22-15233944-C-G	0.833333	10	12	1794	966	828	10
22-15233995-AAT-A	0.666667	6	6	169	79	90	18
22-15236612-T-G	0.666667	8	8	4751	2407	2344	26
22-15237332-A-G	0.666667	8	8	57	26	31	19
22-15240964-A-T	0.5	6	12	293	165	128	23
22-15241267-C-T	0.5	6	12	14331	7702	6629	29
22-15241301-T-A	0.5	6	12	6426	3479	2947	30
22-15241857-C-CA	0.333333	3	4	0	0	0	12
22-15242133-A-C	0.666667	8	8	9617	5196	4421	37
22-15242190-A-T	0.333333	4	10	0	0	0	13
22-15242235-A-G	0.5	6	12	17768	9342	8426	30
22-15242695-G-A	0.166667	2	2	0	0	0	21
22-15242778-A-G	1	12	12	9709	5163	4546	28
22-15243079-A-G	0.583333	7	12	663	362	301	26
22-15243084-TCGG-T	0.25	3	12	509	261	248	10
22-15243231-CAT-C	0.583333	6	7	4966	2913	2053	22
22-15243303-A-G	1	12	12	18576	9830	8746	42
22-15243787-C-CT	0.333333	4	4	1393	762	631	18
22-15244983-C-T	0.5	6	12	10985	5861	5124	33
22-15245188-G-A	0.5	6	12	13521	7147	6374	42
22-15246059-T-TA	0.166667	2	10	609	309	300	16
22-15246223-C-T	0.416667	5	10	606	337	269	27
22-15246377-TA-T	0.666667	8	10	19497	10188	9309	39
22-15246477-C-T	0.25	3	12	2399	1183	1216	15
22-15246992-CA-C	0.416667	3	5	552	291	261	14
22-15248730-G-T	0.5	6	10	41	18	23	21
22-15248864-A-C	0.5	6	6	142	77	65	22
22-15249023-G-A	0.083333	1	8	414	219	195	10
22-15249056-A-G	0.833333	10	10	368	188	180	18
22-15249089-G-T	0.083333	1	12	0	0	0	16
22-15249263-G-A	0.75	10	10	281	138	143	22
22-15249273-A-G	0.25	3	12	3	2	1	26
22-15249656-C-T	0.166667	2	12	221	118	103	17
22-15249659-CT-C	0.5	5	8	1	1	0	10
22-15249755-C-T	1	12	12	2523	1393	1130	19
22-15251426-C-T	0.583333	7	8	37301	19181	18120	25
22-15251587-T-C	0.666667	8	10	10205	5566	4639	21
22-15252275-A-G	0.166667	2	6	1130	610	520	16
22-15252982-CA-C	0.75	9	10	19035	10205	8830	31
22-15253576-C-CA	0.583333	7	12	17357	9035	8322	31
22-15253576-C-CAA	0.416667	5	12	14828	7927	6901	31
22-15255802-G-T	0.75	9	12	20716	10966	9750	29
22-15256019-G-T	1	12	12	0	0	0	29
22-15256657-T-TTC	0.583333	7	8	0	0	0	12
22-15260529-A-G	0.5	6	8	46	23	23	17
22-15260639-A-ATT	0.333333	4	9	1672	895	777	33
22-15261124-G-A	0.666667	8	10	49	26	23	15
22-15261516-A-C	0.166667	2	8	0	0	0	12
22-15263621-G-A	0.166667	2	2	14	7	7	13
22-15263635-T-C	0.833333	10	12	1699	805	894	18
22-15263875-A-G	0.166667	2	6	3	1	2	13
22-15269605-G-A	0.666667	8	10	6616	3562	3054	21
22-15272037-T-C	0.666667	8	10	18486	9475	9011	22
22-15272168-C-T	0.75	9	12	7328	3962	3366	19
22-15272577-T-A	0.416667	5	8	21	9	12	12
22-15274043-A-C	1	12	12	47501	25386	22115	30
22-15274210-A-G	1	12	12	4	2	2	19
22-15274315-T-G	0.333333	4	8	0	0	0	13
22-15275090-G-A	0.166667	2	6	0	0	0	13
22-15278350-G-T	0.25	3	10	2	0	2	16
22-15278861-T-G	0.5	6	12	1	1	0	17
22-15279012-T-C	0.666667	8	10	333	161	172	31
22-15280181-T-C	0.166667	2	4	457	238	219	10
22-15280902-C-A	0.333333	3	12	2242	1120	1122	20
22-15281327-C-T	0.083333	1	8	1873	946	927	12
22-15281360-C-G	1	12	12	26435	14229	12206	31
22-15281883-G-A	1	12	12	19536	10495	9041	36
22-15282134-G-T	0.166667	2	10	1877	946	931	18
22-15282166-A-C	1	12	12	27325	14787	12538	32
22-15282867-A-G	0.416667	5	10	50343	26231	24112	41
22-15284540-A-T	0.25	3	12	3168	1598	1570	11
22-15290487-A-T	0.25	3	12	3335	1693	1642	16
22-15292430-G-A	0.25	3	12	5	3	2	29
22-15292702-T-A	0.166667	2	12	0	0	0	15
22-15295537-CAA-C	0.25	3	12	16547	8677	7870	12
22-15301148-C-T	0.333333	4	10	3450	1871	1579	28
22-15303971-C-T	0.333333	4	10	12925	7070	5855	27
22-15305898-C-CA	0.25	3	11	761	395	366	14
22-15305898-C-CAA	0.25	3	11	2661	1479	1182	14
22-15305941-G-A	0.083333	1	12	0	0	0	10
22-15306065-C-CA	0.166667	2	8	4451	2356	2095	18
22-15306078-C-A	0.166667	2	8	2828	1525	1303	11
22-15312662-CT-C	0.5	6	8	933	480	453	15
22-15316040-G-A	0.083333	1	12	1	1	0	10
22-15319915-AC-A	0.25	3	12	2587	1294	1293	28
22-15321171-A-T	0.166667	2	12	4448	2358	2090	10
22-15321935-C-T	0.583333	6	10	6816	3397	3419	32
22-15322819-C-T	0.5	6	12	1290	647	643	17
22-15323119-C-CA	0.5	5	6	72	41	31	10
22-15325218-T-C	0.75	9	12	2088	1014	1074	23
22-15325630-G-C	0.833333	10	10	8253	4550	3703	35
22-15328349-A-C	1	12	12	45070	23746	21324	40
22-15328553-TAA-T	0.333333	5	9	22	13	9	18
22-15328681-T-A	0.833333	10	10	587	265	322	21
22-15329685-T-G	0.75	9	12	22350	11352	10998	30
22-15330017-C-T	0.75	9	12	30644	15504	15140	37
22-15330537-G-A	0.75	9	12	17851	9160	8691	45
22-15330963-T-C	1	12	12	30497	16327	14170	43
22-15331307-T-C	0.5	6	6	10361	5572	4789	27
22-15331641-A-AT	1	12	12	1289	634	655	20
22-15331656-G-A	0.166667	2	12	2561	1421	1140	18
22-15331872-G-A	0.833333	10	10	1469	781	688	29
22-15331876-C-T	0.833333	10	12	1338	708	630	26
22-15332214-G-A	0.5	6	12	1510	738	772	29
22-15333106-G-C	0.5	6	12	1540	762	778	46
22-15333166-G-A	1	12	12	31659	16770	14889	27
22-15333312-A-G	1	12	12	16556	9140	7416	47
22-15334578-T-C	0.166667	2	10	0	0	0	11
22-15337199-T-A	1	12	12	3968	2165	1803	24
22-15340480-A-C	0.25	3	12	2485	1247	1238	15
22-15340859-T-G	0.333333	4	6	127	57	70	14
22-15341326-A-G	0.75	9	12	21227	10897	10330	30
22-15342394-G-T	0.666667	8	10	21730	11114	10616	30
22-15344989-T-C	1	12	12	15876	8532	7344	33
22-15345070-A-G	1	12	12	33823	17615	16208	35
22-15345560-C-T	0.5	6	8	1719	988	731	16
22-15345988-TG-T	1	12	12	45534	23078	22456	52
22-15346042-C-T	0.25	3	12	2424	1203	1221	34
22-15349250-T-C	0.833333	10	10	56160	29630	26530	25
22-15349257-T-C	0.083333	1	10	0	0	0	24
22-15349642-T-C	1	12	12	50566	25588	24978	29
22-15350551-CT-C	0.416667	6	9	271	156	115	12
22-15351636-G-A	0.333333	4	6	190	93	97	24
22-15352721-G-A	0.166667	2	12	1	0	1	12
22-15353237-T-C	1	12	12	50413	25566	24847	49
22-15353261-C-T	0.75	9	12	22396	11356	11040	44
22-15353753-C-T	0.25	2	12	4784	2511	2273	10
22-15354690-G-A	0.75	9	12	17687	9239	8448	26
22-15356904-A-C	0.166667	2	6	0	0	0	12
22-15357262-A-G	1	12	12	15026	7897	7129	37
22-15357296-A-T	0.75	9	12	16144	8418	7726	41
22-15360336-G-A	1	12	12	47528	24367	23161	33
22-15360353-A-G	0.083333	1	12	20	11	9	10
22-15365822-T-G	0.5	6	6	64	32	32	25
22-15367894-C-T	0.333333	4	8	76	37	39	18
22-15368363-A-C	0.5	6	10	279	143	136	25
22-15368497-T-C	0.833333	10	12	394	191	203	24
22-15371634-G-C	0.75	9	12	21278	10909	10369	35
22-15371708-G-C	0.166667	2	12	282	147	135	28
22-15373355-A-C	1	12	12	45675	23328	22347	44
22-15373381-G-A	0.25	3	12	471	237	234	15
22-15374451-C-A	0.416667	5	12	1067	512	555	30
22-15374942-C-G	0.5	6	8	466	256	210	28
22-15376389-A-G	0.166667	2	8	0	0	0	14
22-15377180-C-T	0.75	9	12	17960	9318	8642	40
22-15377200-T-A	0.666667	8	10	17998	9353	8645	38
22-15377907-C-T	0.083333	1	12	577	291	286	14
22-15377922-A-G	0.083333	1	12	578	295	283	15
22-15378827-A-T	1	12	12	10051	5398	4653	21
22-15379290-G-A	0.166667	2	12	15	9	6	28
22-15379481-A-G	0.666667	8	10	21028	10802	10226	31
22-15379623-T-A	1	12	12	31386	16993	14393	34
22-15380035-A-T	0.666667	8	10	8921	4831	4090	12
22-15380807-G-T	0.583333	7	8	19238	9858	9380	42
22-15381123-T-C	0.166667	2	12	10	7	3	21
22-15386710-G-T	0.75	9	12	5268	2888	2380	25
22-15387306-A-G	0.25	3	12	1592	811	781	13
22-15388149-G-A	0.666667	7	10	1592	715	877	24
22-15388533-G-A	0.25	3	12	322	160	162	13
22-15388995-T-C	0.333333	4	8	318	157	161	19
22-15389868-C-T	0.75	9	12	20376	10377	9999	40
22-15390755-T-C	1	12	12	32574	17474	15100	40
22-15390877-T-C	0.25	3	12	916	476	440	18
22-15391248-A-C	0.833333	10	10	34257	18305	15952	28
22-15392730-A-G	0.416667	5	12	1198	579	619	42
22-15393689-C-T	1	12	12	10732	5934	4798	31
22-15393860-ACACT-A	0.166667	2	10	1757	903	854	11
22-15396805-C-A	0.75	9	12	22089	11209	10880	43
22-15397709-A-T	1	12	12	50475	25602	24873	51
22-15398057-T-C	0.416667	5	10	423	232	191	19
22-15399698-T-A	0.583333	7	8	2581	1401	1180	21
22-15400870-C-T	0.416667	5	10	1136	565	571	17
22-15400888-C-T	0.5	6	6	23490	12340	11150	31
22-15400917-G-A	0.083333	1	12	0	0	0	20
22-15402387-C-A	0.833333	10	12	14625	7911	6714	22
22-15402742-A-G	0.583333	7	10	12638	6366	6272	40
22-15403427-T-C	0.5	6	12	351	161	190	25
22-15403630-G-C	1	12	12	2826	1472	1354	31
22-15405916-G-C	0.416667	5	10	791	417	374	28
22-15406720-C-A	0.75	9	12	18058	9363	8695	40
22-15407229-C-T	0.75	9	12	21616	11104	10512	24
22-15408251-A-G	0.5	6	8	8424	4683	3741	33
22-15410057-T-A	0.166667	2	12	0	0	0	25
22-15410161-C-A	0.833333	10	10	18029	9743	8286	34
22-15410514-G-C	0.583333	7	8	11083	6005	5078	31
22-15410671-T-C	0.833333	10	12	1099	609	490	22
22-15412485-G-A	0.75	9	12	8176	4126	4050	34
22-15413927-T-C	0.75	9	12	10744	5559	5185	35
22-15417653-G-A	0.083333	1	12	56	34	22	11
22-15418549-C-G	1	12	12	43394	22711	20683	55
22-15420206-A-T	0.75	9	12	19101	10201	8900	32
22-15420277-G-A	0.166667	1	12	0	0	0	11
22-15420910-C-T	0.333333	4	10	250	133	117	21
22-15423077-G-T	0.166667	2	12	115	62	53	58
22-15424669-C-T	0.166667	2	12	5	4	1	15
22-15424742-A-G	0.666667	8	12	15241	7963	7278	36
22-15425170-T-C	0.666667	8	12	10651	5519	5132	27
22-15425370-G-A	0.5	6	12	333	175	158	22
22-15426608-A-G	0.75	9	12	23926	12139	11787	40
22-15427152-C-T	0.5	6	10	4262	2438	1824	16
22-15427714-A-T	0.75	9	12	7609	3822	3787	28
22-15429208-T-G	1	12	12	14417	8112	6305	37
22-15429564-A-G	1	12	12	37779	19881	17898	29
22-15430685-G-A	0.583333	6	10	3118	1717	1401	18
22-15430749-T-C	1	12	12	34812	18456	16356	32
22-15431083-T-C	0.583333	7	10	16945	8542	8403	41
22-15431707-C-G	1	12	12	75741	38778	36963	41
22-15435739-T-C	0.416667	5	12	1183	646	537	25
22-15436000-T-C	0.5	6	10	3258	1741	1517	20
22-15437116-T-G	0.083333	1	10	0	0	0	16
22-15437261-G-A	0.75	9	12	24055	12181	11874	39
22-15439536-T-C	0.75	9	12	11763	6449	5314	28
22-15440245-C-T	0.083333	1	12	120	62	58	17
22-15440606-T-G	0.75	9	12	29845	15190	14655	55
22-15443047-T-G	1	12	12	31347	16947	14400	41
22-15444359-C-A	0.5	6	10	2667	1439	1228	20
22-15444373-G-A	0.833333	10	10	1199	611	588	32
22-15445166-T-C	1	12	12	74530	38095	36435	36
22-15446022-C-A	0.25	3	12	5689	3060	2629	28
22-15446047-GA-G	0.25	3	12	1817	930	887	26
22-15447735-G-A	0.833333	10	12	2039	1057	982	22
22-15448311-T-C	0.833333	10	12	7979	4384	3595	26
22-15448496-T-C	1	12	12	2290	1235	1055	37
22-15448968-C-T	0.25	3	12	1588	816	772	13
22-15449522-C-T	0.25	3	12	1707	864	843	17
22-15449810-G-A	1	12	12	27809	14780	13029	44
22-15449903-C-T	0.25	3	12	1101	577	524	25
22-15450340-G-A	0.083333	1	12	0	0	0	18
22-15451478-C-A	0.25	3	12	2442	1233	1209	12
22-15451580-T-C	0.666667	8	10	18255	9925	8330	34
22-15452373-G-C	0.75	9	12	12742	7024	5718	49
22-15454115-G-A	0.5	6	12	9636	5154	4482	28
22-15454233-T-C	0.5	6	8	735	383	352	17
22-15455577-G-A	0.75	9	12	18592	9681	8911	28
22-15457695-C-T	0.333333	4	6	202	95	107	18
22-15459512-G-T	0.75	9	12	2132	1143	989	21
22-15459798-GTGTT-G	0.75	9	12	19381	9870	9511	29
22-15461696-T-TC	1	12	12	2430	1262	1168	29
22-15461834-G-T	0.75	9	12	20079	10655	9424	49
22-15461974-G-A	1	12	12	36372	19282	17090	38
22-15461990-A-G	0.75	9	12	17786	9414	8372	29
22-15462046-C-T	0.5	6	12	1325	643	682	28
22-15462367-ACATAGGATTCCAGAACACTGCTGCTGGGTTCTGAGTGTTTCTCCCTCT-A	0.666667	8	12	168	71	97	13
22-15463803-C-T	0.25	3	12	2505	1256	1249	11
22-15465172-G-T	1	12	12	8166	4295	3871	28
22-15465399-C-G	0.666667	8	12	14519	7305	7214	24
22-15465444-C-G	1	12	12	49639	25163	24476	50
22-15465472-A-C	1	12	12	50360	25537	24823	48
22-15465956-G-A	0.666667	8	10	6683	3701	2982	31
22-15466133-G-A	1	12	12	1399	730	669	34
22-15466244-A-G	1	12	12	44034	22849	21185	44
22-15467515-T-G	0.5	6	6	1866	1039	827	17
22-15467922-G-T	0.833333	10	10	16449	8865	7584	29
22-15468108-A-G	0.5	6	10	12731	6931	5800	16
22-15468916-C-T	0.25	3	4	1321	626	695	18
22-15472112-T-TCACA	0.25	3	7	2710	1431	1279	21
22-15472112-T-TCACACA	0.166667	2	7	3147	1714	1433	21
22-15472159-C-A	0.333333	4	8	15494	8099	7395	31
22-15473463-G-A	1	12	12	35406	18710	16696	19
22-15473472-C-T	1	12	12	36496	19297	17199	22
22-15473564-G-A	1	12	12	22963	12676	10287	28
22-15473621-AT-A	0.916667	11	12	17964	9774	8190	34
22-15473670-T-C	1	12	12	16930	9222	7708	42
22-15474252-T-A	0.5	6	10	0	0	0	18
22-15475155-T-C	0.5	6	6	9158	5036	4122	27
22-15476160-G-A	0.416667	5	12	455	235	220	17
22-15478374-C-CGT	0.166667	2	8	176	83	93	19
22-15478375-A-G	0.5	6	9	8443	4168	4275	21
22-15478375-A-ATG	0.416667	3	9	1592	822	770	21
22-15479304-T-A	0.25	3	8	842	422	420	18
22-15479320-A-C	0.5	6	6	11958	6152	5806	36
22-15480826-T-C	0.75	9	12	8152	3938	4214	35
22-15481368-T-C	0.833333	10	10	863	440	423	15
22-15483490-A-G	0.5	5	12	70	30	40	11
22-15483719-TTATATA-T	0.666667	8	12	13913	7257	6656	24
22-15483719-TTATATATA-T	0.333333	4	12	4040	2091	1949	24
22-15484112-A-T	0.25	3	4	11131	5609	5522	12
22-15486342-A-C	1	12	12	5968	3171	2797	23
22-15487345-A-G	0.75	9	12	23726	12016	11710	47
22-15487692-TA-T	0.25	3	7	10771	5664	5107	14
22-15488004-A-G	0.833333	10	10	3	1	2	30
22-15488258-G-A	0.666667	8	10	22450	11500	10950	28
22-15489149-G-C	0.5	6	12	12	5	7	20
22-15489309-C-CT	0.666667	8	10	10725	6020	4705	28
22-15489360-A-G	1	12	12	38530	20330	18200	46
22-15489973-T-C	0.083333	1	12	43	24	19	18
22-15490382-T-TTG	0.333333	4	9	7101	3648	3453	26
22-15491945-T-C	1	12	12	39306	20473	18833	36
22-15492072-C-G	0.583333	7	12	6012	3279	2733	30
22-15492127-A-C	0.166667	2	12	14	5	9	31
22-15492872-T-A	0.5	6	8	16941	9008	7933	34
22-15493116-TTTTATTTA-T	0.416667	4	10	1558	839	719	21
22-15493116-TTTTA-T	0.083333	1	10	1165	647	518	21
22-15493211-G-A	0.583333	7	10	2386	1259	1127	30
22-15495413-T-G	0.583333	7	10	2506	1380	1126	24
22-15495531-T-A	0.166667	2	8	0	0	0	11
22-15497148-T-C	0.666667	8	12	22084	11326	10758	28
22-15497276-A-G	0.166667	2	10	0	0	0	17
22-15497539-C-T	0.166667	2	12	4147	2248	1899	10
22-15497813-T-C	0.166667	2	4	0	0	0	10
22-15499727-C-T	0.083333	1	12	664	377	287	22
22-15500082-A-C	0.25	3	12	615	318	297	13
22-15500462-T-C	0.333333	4	10	NA	NA	NA	12
22-15500520-A-G	0.5	6	12	54	35	19	33
22-15502032-C-T	0.5	6	12	814	472	342	29
22-15503490-T-G	0.166667	1	12	111	42	69	20
22-15503622-T-G	0.083333	1	12	0	0	0	10
22-15504311-C-T	0.5	6	6	937	507	430	40
22-15506502-T-C	0.166667	2	4	3124	1684	1440	21
22-15506812-A-G	0.666667	8	10	1606	876	730	17
22-15506921-G-T	0.333333	4	8	171	82	89	24
22-15508761-A-G	1	12	12	36723	19498	17225	25
22-15511594-G-A	0.666667	8	10	12756	6809	5947	16
22-15513247-C-T	0.75	9	12	22664	11574	11090	55
22-15513405-A-G	1	12	12	59356	31199	28157	31
22-15513541-G-T	0.75	9	12	23938	12105	11833	47
22-15513717-G-T	1	12	12	23757	12640	11117	34
22-15514924-T-C	0.166667	2	10	719	371	348	16
22-15515496-A-T	0.75	9	12	22494	11444	11050	34
22-15515691-G-A	0.25	3	12	191	101	90	17
22-15517800-G-GC	0.5	6	10	3703	2117	1586	19
22-15518304-CTATA-C	0.5	6	12	904	446	458	30
22-15518376-T-C	0.333333	4	12	2136	1108	1028	26
22-15520787-T-G	1	12	12	59756	31543	28213	38
22-15525573-A-G	0.333333	4	4	1778	1008	770	20
22-15544192-A-G	0.25	3	8	19067	9930	9137	13
22-15546891-GT-G	0.666667	8	10	497	250	247	28
22-15546892-T-G	0.166667	2	10	0	0	0	28
22-15547151-TAC-T	0.25	3	9	283	153	130	18
22-15547151-T-TACAC	0.166667	2	9	253	140	113	18
22-15547418-CA-C	0.5	5	10	9419	5043	4376	16
22-15549456-A-G	0.333333	4	12	23694	12099	11595	36
22-15549664-G-A	0.25	3	12	12302	6402	5900	31
22-15551613-G-T	0.666667	8	8	0	0	0	16
22-15552149-G-A	0.166667	2	10	715	359	356	16
22-15552376-T-C	0.083333	1	12	16	8	8	19
22-15562148-A-G	0.333333	4	8	41	21	20	12
22-15562384-C-A	0.5	6	12	627	302	325	27
22-15563176-A-G	0.333333	4	6	15	8	7	14
22-15564722-A-T	0.666667	8	10	13704	6978	6726	23
22-15568853-G-A	0.666667	7	10	4769	2422	2347	29
22-15570001-G-T	0.666667	8	8	10959	5969	4990	18
22-15570843-A-C	1	12	12	11279	6053	5226	46
22-15571621-G-A	0.5	6	8	11033	5885	5148	25
22-15571833-G-A	0.5	6	10	2175	1177	998	44
22-15573106-G-GT	0.333333	4	8	6660	3493	3167	25
22-15573106-GTTTTTTTT-G	0.083333	2	8	0	0	0	25
22-15575877-T-C	1	12	12	46144	23773	22371	28
22-15576350-C-T	0.166667	2	12	3	3	0	11
22-15577457-A-AAC	0.75	9	12	8294	4196	4098	22
22-15577566-G-A	0.333333	4	4	16558	9069	7489	20
22-15580012-A-G	1	12	12	0	0	0	26
22-15584651-C-T	0.25	3	12	2779	1396	1383	29
22-15584652-G-A	0.75	9	12	25800	12991	12809	48
22-15585849-A-C	0.333333	4	10	0	0	0	10
22-15589662-T-C	0.5	6	6	2975	1628	1347	26
22-15590051-T-C	0.833333	10	10	1602	843	759	20
22-15590583-C-A	0.666667	8	12	2138	1198	940	29
22-15590852-A-G	1	12	12	43078	22670	20408	32
22-15590991-G-A	0.25	3	12	2464	1264	1200	11
22-15593414-CA-C	0.083333	1	1	3194	1651	1543	12
22-15596849-A-AAAT	0.166667	2	8	267	158	109	15
22-15596954-A-G	0.666667	8	12	33197	17618	15579	18
22-15596996-TTTTA-T	0.166667	2	5	18	10	8	16
22-15599178-C-CT	0.166667	1	2	12	9	3	10
22-15600523-A-G	0.333333	4	8	308	158	150	11
22-15601652-T-C	0.083333	1	12	2	1	1	22
22-15602202-A-G	1	12	12	0	0	0	35
22-15604909-G-A	0.083333	1	12	180	86	94	22
22-15606422-G-GAT	0.166667	1	10	8	5	3	15
22-15607935-CT-C	0.083333	1	8	103	57	46	14
22-15612674-C-T	0.25	3	6	30159	16912	13247	21
22-15613040-G-T	0.166667	2	10	19194	9990	9204	14
22-15614150-C-T	0.083333	1	12	13	9	4	11
22-15614278-C-CA	0.166667	2	10	49	28	21	11
22-15616659-G-A	0.25	3	12	561	295	266	26
22-15616908-GA-G	0.083333	1	12	3	1	2	13
22-15616968-C-A	0.166667	2	10	330	183	147	12
22-15618399-CA-C	0.25	3	6	11050	5911	5139	14
22-15619386-A-C	0.166667	2	12	2	2	0	21
22-15620107-C-T	0.166667	2	10	1466	792	674	27
22-15620117-A-C	0.25	3	10	15167	8138	7029	29
22-15620519-A-C	0.083333	1	8	1918	1004	914	16
22-15620530-A-C	0.166667	2	8	13609	7314	6295	14
22-15620863-C-T	0.166667	2	12	23	12	11	15
22-15626359-C-G	0.5	5	10	20401	10574	9827	13
22-15632562-C-A	0.25	3	6	58617	30098	28519	32
22-15633029-A-G	0.416667	5	6	58716	30063	28653	36
22-15633549-C-A	0.166667	2	4	57436	29405	28031	42
22-15636278-T-C	0.25	3	12	3690	1901	1789	13
22-15636469-G-A	0.25	3	12	3449	1749	1700	18
22-15636539-G-A	0.166667	2	12	2	0	2	23
22-15636847-G-A	0.25	3	12	3594	1818	1776	21
22-15640190-T-C	0.083333	1	4	27	15	12	12
22-15642916-TG-T	0.333333	4	4	24	8	16	15
22-15645958-G-A	0.166667	2	12	476	219	257	23
22-15653698-T-G	0.666667	8	12	4587	2475	2112	31
22-15657728-A-G	0.5	6	12	195	95	100	10
22-15658128-T-C	0.333333	4	8	1974	935	1039	18
22-15658896-G-A	0.833333	10	10	10	2	8	26
22-15662360-A-T	0.5	6	8	2729	1411	1318	24
22-15664046-T-C	0.5	6	8	18	9	9	14
22-15664804-T-G	0.75	9	10	21445	11049	10396	37
22-15665506-T-G	0.333333	4	10	5534	2913	2621	50
22-15666489-T-C	0.333333	4	8	19577	10276	9301	27
22-15667040-T-C	0.333333	4	10	206	101	105	20
22-15668259-T-C	0.666667	8	8	30333	15836	14497	27
22-15671203-C-T	0.166667	2	10	48	23	25	15
22-15671362-A-G	0.333333	4	10	247	135	112	14
22-15672464-T-C	0.833333	10	12	21838	11523	10315	36
22-15672497-T-C	0.75	9	10	21766	11408	10358	35
22-15675309-A-AT	0.25	2	6	726	404	322	17
22-15675666-A-G	0.5	6	10	16317	8328	7989	10
22-15675826-A-G	0.166667	2	12	3	3	0	10
22-15677705-T-C	0.666667	8	8	16592	8729	7863	38
22-15677888-T-TGA	0.333333	2	4	1582	882	700	31
22-15677908-A-AGAGAAAGT	0.083333	1	4	114	63	51	10
22-15678811-A-G	0.166667	2	10	0	0	0	10
22-15680951-T-G	0.416667	5	8	4305	2236	2069	28
22-15682677-C-T	0.666667	8	12	332	158	174	22
22-15682988-G-A	0.5	6	12	118	41	77	14
22-15685962-G-GCA	0.333333	3	8	163	82	81	13
22-15687108-C-T	0.333333	4	10	6529	3474	3055	29
22-15688109-CT-C	0.25	4	10	3595	1912	1683	35
22-15688290-A-G	0.333333	4	10	10584	5624	4960	35
22-15688899-G-C	0.083333	1	6	4	2	2	18
22-15689187-T-C	0.833333	10	12	34657	18039	16618	53
22-15689221-C-G	0.75	9	10	30170	15817	14353	44
22-15689224-A-C	0.416667	5	8	13164	7009	6155	11
22-15689425-A-G	0.666667	8	10	19057	9873	9184	30
22-15689861-CGTGGGGTCGCCCAGCGTGGGT-C	0.083333	1	4	12	7	5	18
22-15690808-C-A	0.083333	1	8	2419	1179	1240	12
22-15691495-G-C	0.583333	7	12	22124	11623	10501	45
22-15691498-C-G	0.333333	4	10	2711	1465	1246	40
22-15691521-G-C	0.333333	4	10	1023	534	489	19
22-15691525-CAA-C	0.5	6	8	415	195	220	10
22-15691966-C-T	0.166667	2	8	6454	3526	2928	10
22-15691981-GATAC-G	0.083333	1	7	2607	1429	1178	22
22-15691985-CATAT-C	0.583333	5	7	2421	1223	1198	22
22-15692003-T-A	0.083333	1	8	3689	2012	1677	18
22-15692007-T-A	0.166667	2	10	3762	2066	1696	18
22-15692009-A-AC	0.25	3	12	3862	2127	1735	20
22-15692613-C-G	0.666667	8	8	7718	4065	3653	39
22-15696815-C-T	0.166667	2	12	4453	2329	2124	13
22-15698123-G-A	0.166667	2	4	15103	8229	6874	19
22-15699566-T-C	0.083333	1	4	0	0	0	13
22-15703483-G-C	0.25	3	12	1200	643	557	19
22-15708134-AT-A	0.083333	1	3	32	17	15	14
22-15710405-A-G	0.166667	2	6	43625	22637	20988	26
22-15712910-G-A	0.166667	2	10	24022	12150	11872	17
22-15715961-A-C	0.25	3	12	23	15	8	13
22-15717285-C-T	0.25	3	12	13777	7297	6480	47
22-15722028-A-C	0.166667	2	8	29	14	15	12
22-15722318-A-G	0.166667	2	10	888	480	408	10
22-15722437-C-T	0.166667	2	10	4	0	4	31
22-15722446-A-G	0.166667	2	8	0	0	0	21
22-15725431-T-C	0.166667	2	10	292	148	144	21
22-15725550-T-A	0.166667	2	6	138	77	61	18
22-15726628-G-A	0.333333	4	10	30057	16157	13900	25
22-15726744-A-T	0.083333	1	6	4455	2196	2259	10
22-15726861-C-A	0.25	3	4	349	192	157	10
22-15727104-G-T	0.166667	2	12	4530	2389	2141	17
22-15728526-G-A	0.083333	1	12	38	23	15	10
22-15729533-T-C	0.166667	2	4	44061	22712	21349	32
22-15729604-C-T	0.083333	1	8	130	69	61	16
22-15732363-A-C	0.166667	2	12	868	461	407	14
22-15734973-G-A	0.166667	2	6	4055	2297	1758	35
22-15735362-A-G	0.166667	2	12	190	84	106	16
22-15735687-TAA-T	0.25	3	12	10577	5425	5152	14
22-15736076-G-C	0.166667	2	12	3881	2026	1855	19
22-15736105-G-A	0.083333	1	8	10786	5469	5317	25
22-15740094-T-C	1	12	12	291	158	133	31
22-15742231-C-A	0.416667	5	12	44947	23107	21840	56
22-15743917-T-TTG	0.166667	2	8	839	445	394	13
22-15743917-T-TTGTG	0.083333	1	8	2841	1550	1291	13
22-15745838-CCTTT-C	0.333333	4	12	50	23	27	13
22-15745838-CCTTTCTTT-C	0.25	3	12	26	13	13	13
22-15745964-CTCCTTCCTTCCT-C	0.166667	2	10	343	180	163	31
22-15746158-ATTTTTTT-A	0.166667	2	4	2	2	0	16
22-15746158-AT-A	0.083333	1	4	82	44	38	16
22-15746592-T-A	0.25	3	12	1214	609	605	10
22-15748568-A-G	0.25	3	4	47273	24099	23174	52
22-15750096-A-AAAAAG	0.083333	1	10	124	65	59	18
22-15756069-A-T	0.166667	2	12	29	12	17	16
22-15758320-A-C	0.25	3	12	1829	939	890	24
22-15761005-G-A	0.166667	2	8	0	0	0	30
22-15761039-G-A	0.166667	2	10	2	1	1	11
22-15761154-G-A	0.083333	1	12	0	0	0	16
22-15761396-A-C	0.083333	1	12	0	0	0	24
22-15764207-A-C	0.5	6	10	0	0	0	21
22-15765713-T-C	0.75	9	10	20228	10969	9259	37
22-15766332-A-G	1	12	12	40909	21732	19177	31
22-15766418-T-A	0.666667	8	8	30440	16007	14433	34
22-15767170-G-A	0.25	3	12	3779	1864	1915	21
22-15769208-G-A	0.25	3	12	417	213	204	10
22-15769389-G-T	0.416667	5	8	144	56	88	14
22-15770929-G-A	0.083333	1	8	462	222	240	13
22-15776849-G-T	0.25	3	12	12678	6435	6243	26
22-15777039-T-C	0.083333	1	12	284	130	154	10
22-15778460-G-A	1	12	12	74959	38320	36639	54
22-15779414-C-T	0.416667	5	8	552	292	260	18
22-15779887-T-C	0.083333	1	12	5	2	3	11
22-15780942-T-TG	1	12	12	42	15	27	27
22-15781449-A-G	0.166667	2	12	927	494	433	15
22-15786741-C-G	0.25	3	10	1	1	0	21
22-15786866-ATT-A	0.083333	1	2	0	0	0	16
22-15787900-A-AT	1	12	12	51231	27214	24017	34
22-15790464-A-G	1	12	12	3162	1666	1496	29
22-15794119-G-T	0.333333	4	10	133	65	68	17
22-15796219-A-G	0.333333	4	8	0	0	0	15
22-15798343-C-CA	0.583333	6	10	89	44	45	15
22-15800358-C-T	0.5	6	10	124	72	52	24
22-15801037-A-T	0.666667	8	8	27944	14457	13487	40
22-15804609-C-CAA	0.083333	1	2	416	221	195	12
22-15805091-T-G	0.333333	4	8	4	3	1	19
22-15806746-A-G	0.166667	2	12	0	0	0	11
22-15807197-G-A	0.166667	2	10	54	27	27	12
22-15807646-G-A	0.333333	4	8	0	0	0	11
22-15808581-G-T	0.166667	2	8	15	10	5	11
22-15808865-CA-C	0.333333	4	6	200	103	97	22
22-15808865-C-CAA	0.083333	1	6	0	0	0	22
22-15809089-C-T	0.5	6	10	127	75	52	22
22-15809098-G-A	0.083333	1	10	72	43	29	10
22-15809310-G-A	0.75	9	10	3410	1753	1657	25
22-15809421-T-C	0.833333	10	12	13437	6978	6459	28
22-15811776-C-T	0.166667	2	4	3	2	1	12
22-15811791-A-C	0.5	6	8	11	7	4	15
22-15811833-G-GA	0.333333	4	10	7	5	2	13
22-15811982-G-A	0.416667	5	12	320	180	140	19
22-15812190-A-T	0.333333	4	10	3083	1686	1397	13
22-15814205-G-A	0.5	6	8	2	1	1	19
22-15816606-A-G	0.666667	8	8	2905	1439	1466	32
22-15818099-G-A	0.166667	2	12	140	77	63	10
22-15818805-T-C	1	12	12	30000	16120	13880	25
22-15818903-C-T	1	12	12	59659	30668	28991	53
22-15819819-C-T	0.166667	2	2	933	483	450	19
22-15820341-C-G	0.333333	4	6	8754	4418	4336	11
22-15820360-C-G	0.833333	10	12	19314	9938	9376	18
22-15820467-T-C	0.833333	10	12	18031	9368	8663	22
22-15820514-A-G	0.666667	8	10	1714	921	793	16
22-15821022-C-G	0.833333	10	10	1910	1045	865	17
22-15821272-C-T	0.416667	4	6	1927	930	997	30
22-15821519-T-TCAC	1	12	12	63625	32930	30695	36
22-15821768-C-T	0.416667	4	12	750	398	352	20
22-15821815-CG-C	0.916667	11	12	8503	4558	3945	32
22-15822740-G-A	0.333333	4	8	0	0	0	15
22-15822816-C-T	0.75	9	12	497	280	217	29
22-15823090-A-C	0.75	9	12	30294	15481	14813	36
22-15823448-G-A	0.25	3	6	1401	707	694	36
22-15824908-G-A	0.083333	1	4	115	52	63	15
22-15825322-G-A	0.916667	11	12	10179	5336	4843	28
22-15825357-A-G	1	12	12	21538	12055	9483	32
22-15825360-C-G	0.583333	7	8	3158	1804	1354	21
22-15825513-T-C	1	12	12	62072	32288	29784	41
22-15826271-A-G	0.666667	8	12	8259	4192	4067	35
22-15827374-G-T	0.666667	8	8	0	0	0	17
22-15827765-G-A	1	12	12	31903	17168	14735	35
22-15828112-C-T	1	12	12	27678	14580	13098	24
22-15828220-A-T	1	12	12	17612	9686	7926	32
22-15828271-C-A	0.166667	2	4	156	87	69	16
22-15828379-C-A	0.333333	4	10	2234	1266	968	12
22-15830069-TG-T	0.25	3	4	3926	2036	1890	17
22-15830758-A-AAAG	0.666667	8	10	249	139	110	22
22-15831192-A-T	0.166667	2	8	2746	1520	1226	11
22-15833537-T-TA	0.333333	2	8	394	225	169	15
22-15833710-CA-C	1	12	12	25117	13556	11561	28
22-15833850-A-G	1	12	12	8786	4994	3792	23
22-15834017-T-C	1	12	12	64647	33387	31260	48
22-15834508-C-T	1	12	12	64626	33415	31211	27
22-15836179-A-T	1	12	12	58924	30407	28517	41
22-15836799-C-T	1	12	12	52578	28136	24442	51
22-15836972-T-G	1	12	12	37453	20256	17197	47
22-15837167-T-TAGAC	0.166667	2	12	2029	1040	989	24
22-15837171-T-C	0.25	3	12	6789	3498	3291	38
22-15837171-T-TAGAC	0.333333	4	12	5904	3034	2870	38
22-15837171-TAGAC-T	0.333333	4	12	2383	1249	1134	38
22-15837593-T-C	1	12	12	27768	15140	12628	28
22-15839394-A-G	1	12	12	67092	34564	32528	36
22-15841397-T-C	1	12	12	41909	21333	20576	37
22-15842588-GT-G	0.333333	4	8	6342	3250	3092	31
22-15842588-GTT-G	0.25	3	8	4932	2530	2402	31
22-15844258-A-G	0.166667	2	6	121	66	55	11
22-15845862-C-T	1	12	12	68076	35093	32983	36
22-15847405-G-T	0.166667	2	10	72	38	34	13
22-15853708-G-GTTT	0.083333	1	1	152	83	69	18
22-15854151-G-A	0.25	3	12	990	482	508	22
22-15854494-A-C	0.25	3	6	10181	5011	5170	30
22-15857405-G-T	0.5	6	10	0	0	0	18
22-15864015-G-C	0.083333	1	8	1	0	1	13
22-15864055-A-C	0.083333	1	10	0	0	0	15
22-15864071-A-G	0.583333	7	10	36149	18853	17296	50
22-15864078-G-A	0.25	3	8	50	25	25	15
22-15869633-A-G	0.25	3	12	1133	610	523	26
22-15872303-C-T	0.166667	2	12	1	1	0	20
22-15872337-G-A	0.75	9	12	2766	1554	1212	41
22-15872577-A-G	1	12	12	36885	19243	17642	23
22-15872835-G-C	0.75	9	10	3276	1637	1639	19
22-15873578-A-G	0.25	3	12	441	228	213	17
22-15874930-C-T	0.166667	2	12	0	0	0	11
22-15875818-C-T	0.25	3	4	10371	5314	5057	17
22-15877641-T-C	0.166667	2	8	3	1	2	12
22-15878006-G-A	0.166667	2	8	20030	11072	8958	25
22-15879649-T-G	0.333333	4	8	2119	1151	968	28
22-15879729-G-A	0.166667	2	6	76	44	32	15
22-15879942-G-GAAAAC	0.25	3	4	8129	4051	4078	27
22-15880382-C-G	0.333333	4	8	54	26	28	31
22-15880780-CA-C	0.5	6	8	232	106	126	10
22-15881057-GAA-G	0.083333	1	3	424	221	203	12
22-15885888-G-C	0.333333	4	4	5	3	2	10
22-15886164-G-C	0.166667	2	6	10	4	6	22
